Tom can't come in.	Tom kać bolo daea.
Is that difficult to do?	Ena difficult gea chi?
Morphology.	Morphology.
Where do you come from?	Ape do okon renko?
Those who want to stay can stay.	Tae sukukô tan kokô tae daea.
Do you have a car?	Aben taḱ Car menaḱa?
"In the case of patient death during the course of medical treatment, even if there is medical error present, it is not automatically legally considered to be an ""unusual death."""	"Medical Treatment sesen tan Course re Patient Gonoć hoban re, Medical Error menaḱ reó, ena do epenkate Law lekate ""unusual Gonoć"" mente ká menoḱa."
I'm hungry!	Rengećń tana!
Duck!	Ungut́enn pe!
Feral children lack the basic social skills that are normally learned in the process of enculturation.	Birbagehon ko taḱ, normally do Enculturation Process te etooḱ basic Sangetalaaḱepeto (social skill) kaa taena.
Tunisia has a history of labor emigration.	Tunisia re Labour koaḱ Disumbanage reaḱ Sidaehonoba menaḱa.
I wasn't able to do everything I wanted to do.	Paiṭi sanaṅiń taekenaḱ ko saben kań pura dae eana.
We are in school.	School re menaḱbua.
I like to run.	Nir sukuńa.
Tom has a Ford.	Tom taḱ miat́ Ford menaḱa.
Why are you laughing?	Chikateben landaê tana?
Indian movies, music, and spiritual teachings play an increasing role in global culture.	Indian-movie, music, spiritual-teaching ko do global Culture re increasing Role menaḱa.
We have to remember that the choices of individual human beings led to repeated world war. But we also have to remember that the choices of individual human beings created a United Nations, so that a war like that would never happen again.	Mipiat́ hoo koaḱ Sala Sanaṅ ko te repeated Otesae Gopoć ko hoba akana mentebu uṛuḱ rikaê te hobana. Mipiat́ hoo koaḱ Sala Sanaṅ ko te ge mendo, enkan Gopoć anḍoḱ alakâ hoban mente United Nations bai eanaḱ óbu uṛuḱ rikaê te hobana.
I'm never not hungry.	Jahìmita ó Rengeć banoḱ gedo baṅińa.
I can't listen to stupid people.	Onḍo Hoo koaḱ Kaji kań ayum daea.
Gold's heavier than iron.	Samaom do Meeht́ aete ó hambala.
The village was burnt down.	Hatu ló chaba eana.
However, several species of bacteria are pathogenic and cause infectious diseases, including cholera, syphilis, anthrax, leprosy, tuberculosis, tetanus and bubonic plague.	Enkareóge, several Bacteriahita dokô pathogenic gea, anḍoḱ enko te Cholera,, Syphilis,, Anthrax,, Tunḍubanḍia,, Tuberculosis,, Tetanus,, Bubonic Plague ko lekan Chaálrua (Infectious Diseases) ko ooḱla.
It has unresolved territorial disputes with China and with Pakistan.	India aḱ China,, Pakistan loḱ kaa resolve akan ote chirmit́ dispute menaḱa.
I don't want to tell you how I did that.	Ena chilika teń Paeṭi ket́a menteaḱ ká kajiam sanaṅiń tana.
Bacteria were first observed by the Dutch microscopist Antonie van Leeuwenhoek in 1676, using a single-lens microscope of his own design.	Bacteria do ayarùtar 1676 re Dutch Microscopist Antonie van Leeuwenhoek aćge design let́ Single-lens Nelmansanaṕ tekô nel lena.
We don't have that kind of money.	Imin Puisa banoḱa tale.
The village was burnt down.	Hatu atar chaba eana.
Gold's heavier than iron.	Samaom do Meeht́ aete hambala.
What would you like to eat?	Chenaḱm jomêa?
I don't know when he will arrive.	Chuilać hujoḱa kań adaana.
Calm down.	Hapann pe.
Did the two of you meet in Boston?	Boston reben napam lena chi?
I have a car.	Ań taḱ Car menaḱa.
The space station not only served as a laboratory and living space for astronauts, but also as a support base for other spacecraft which had the ability to dock with the station.	Space Station do, Astronaut koaḱ Laboratory anḍoḱ Taenpai leka sekar ge mena do ká, en Station loḱ soporoḱ dae eṭaḱ Spacecraft ko lagit́ Support Base leka ó Paeṭić emê taekena.
What are you doing?	Chenaḱm chika tana?
It is a village.	Ena do Hatu.
I didn't mean to wake you.	Evn ichim teaḱ do kań sanaṅ kena.
Umbrellas sell well.	Chatom ko bugi akarińoḱa.
China is bigger than Japan.	China do, Japan aete maraṅa.
Ancient Greek ko India renko do Indoi (Ἰνδοί) kô metakô taekena, ena reaḱ translation do “Indus gaḍa ren ko”.	"The ancient Greeks referred to the Indians as Indoi (Ἰνδοί), which translates as ""The people of the Indus""."
Show me how.	Uduṕań ben chilikate.
Are you happy?	Rãasa repea chi kaa?
Although the term bacteria traditionally included all prokaryotes, the scientific classification changed after the discovery in the 1990s that prokaryotes consist of two very different groups of organisms that evolved from an ancient common ancestor.	Bacteria, nen Term re traditionally do sanam Prokaryote ko agumesaoḱ taeken reó ge, Prokaryote kore miat́ ge Ancient Common Ancestor aete haratersa akan barea esu rená tannga Organism Group menaḱ mente 1990 kore urum ean tayom, Scientific Classification ol ruaa eana.
Robert then survived in the wild, presumably with vervet monkeys, for three years until he was found by soldiers of National Resistance Army.	Robert do National Resistance Army ren Soldier ko nam let́ić jóṅ apea sirma Bir reć jivt́ lena, presumably Vervet Gai ko loḱ.
Tell me.	Kajiań ben.
What are you doing?	Chenaḱben chika tana?
I'm a student.	Paṛao tanań.
India was the world's second-largest textile exporter after China in the 2013 calendar year.	2013 sirma, India do China tayom Otesai chetan baáraḱ-maraṅ Textile Eéxportdisum lena.
Say it again.	anḍoḱ misa kajiêben.
He's flexible.	Flexible geać.
Have you washed the dishes?	Bela koben gasar ket́a chi?
I have less than you.	Am aete huḍiń menaḱa ań taḱ re.
Where does it hurt?	Okontaḱ hasuben tana?
Most do not cause diseases, are beneficial to their environments, and are essential for life.	Enko láḱpaa ko tedo Ruahasu kaa ooḱla, tako Environment lagit́kô beneficial gea, oḍok Jinivt́ lagit́kô essential gea.
With North Korea's announcement on the 26th of its nuclear development plan based upon the agreement stemming from the Six Party Talks, and the United States' commencement of procedures to remove North Korea from its designation on the list of State Sponsors of Terrorism, the families of abductees have expressed growing unease that it may constitute an abandonment of the abductee issue.	North Korea ren ko 26 musiṅg Turui Party Japagar aete ooḱl akan Agreement chetanaḱ Nuclear Development Plan kô announce ket́aḱ te, anḍoḱ State Sponsors of Terrorism List re North Korea olmesa akanaḱ atomê teaḱ Process United States ren ko eṭećê teaḱ te, Abductee Issue reaḱ Banage hoban chi toraṅ mente Abductee koaḱ Family ren ko growing unease kô express akat́a.
I was told not to do that.	Ena alamà' kô metat́ińa.
What's he doing over there?	Akin han re chenaḱkin chika tana?
Some researchers also include the opposite effect for high performers: their tendency to underestimate their skills.	Chiminaṅ Researcher ko do, high performer kore ena reaḱ opposite effect (skill underestimate enn teaḱ tendency) ókô include êa.
I have a husband.	Koaanań.
By 55,000 years ago, the first modern humans, or Homo sapiens, had arrived on the Indian subcontinent from Africa, where they had earlier evolved.	55,000 sirma maaṅ loḱ do, ayarutar modern-human ko (Homo sapien ko), ako sidae evolve len Africa aete Indian subcontinent kô hućoḱ sekaa ean taekena.
I am rich.	Puisaanań.
Tom doesn't speak Spanish.	Tom Spanish kać jagar etoêa.
Modern humans arrived on the Indian subcontinent from Africa no later than 55,000 years ago.	Modern human ko do Africa aete Indian subcontinent te tapayomutar 55,000 sirma maaṅ rekô hućoḱ lena.
Its evidence today is found in the hymns of the Rigveda.	Ena reaḱ Evidence Rigveda reaḱ Hymn kore namoḱa.
The world is a village.	Nen Otesae miat́ Hatu.
Modern bioethicists who advocate new eugenics characterize it as a way of enhancing individual traits, regardless of group membership.	New Eugenics advocate ê tan Modern bioethicist ko do, ena regardless of group membership, individual aḱ Trait ko enhance ê tan Hora lekakô characterize êa.
I am married.	Aandi akanań.
We live on different continents.	Eṭaḱ-eṭaḱ Continent relaṅa.
However, it has remained lower than those of other Asian developing countries such as Indonesia, Malaysia, Philippines, Sri Lanka, and Thailand, and is expected to remain so in the near future.	Enkareóge, ena do Indonesia, Malaysia, Philippines, Sri Lanka, anḍoḱ Thailand lekan eṭaḱ Asia ren Developing Disum ko aete ó latar rea, anḍoḱ Kanalom ó enka ge taena mente Expectation menaḱa.
Do you want to play?	Inuṅam?
Before them, Ignaz Semmelweis and Joseph Lister had realised the importance of sanitised hands in medical work.	Akin ayar, Ignaz Sammelweis anḍoḱ Joseph Lister do Medical Paeṭi re Tí Sanitisation reaḱ Importance kin chirgal let́ taekena.
The villages are thirsty.	Hatu re Daḱkô ringa tana.
Why are you dancing?	Chenaḱ menteben susun tana?
Good morning!	Setaḱ Siṅgi joar!
A feral child (also called wild child) is a young individual who has lived isolated from human contact from a very young age, with little or no experience of human care, social behavior, or language.	Birbagehon (wild child ókô metaà) do, Baleḱtaesirma aete ge Hoojanapaḱ (human contact) sangin re tannga akan aete, Hooneélsapaṕ (human care),, sangitala Sepentapae (social behaviour),, Jagar reaḱ Nelàdasẽa (experience), menaḱ re jokoć ge baredo banoḱ lekan baleḱ Individual.
America wanted, and still wants, to support the countries bordering Russia in order to destabilize it.	America ren ko Russia destabilize ê lagit́ ena Chirmit́ ren Disum kokô support sanaṅ kena, sanaṅ tan geakô.
You'll be a grandmother soon.	Anjaa gem Jiaṅoḱa.
We are in Paris.	Paris rebua.
I like fish.	Hać koń sukuaà.
Tom is wearing a new pair of jeans.	Tom nama Jeans eć tusiṅ akat́a.
That's why cats love you.	Enamente Bilae kokô sukutemea.
He is from our village.	Ać do abu Hatu renić.
I'm a student.	School tanań.
When Harsha of Kannauj, who ruled much of the Indo-Gangetic Plain from 606 to 647 CE, attempted to expand southwards, he was defeated by the Chalukya ruler of the Deccan.	606 aete 647 CE re Indo-Gangetic Plain goṭa naeć rule ken Kannauj ren Harsha south paa teć expand lekead re, Deccan ren Chalukya ruler taḱaeteć haratiṅ eana.
I'm going to a meeting.	Miat́ Dunuṕ taḱń senoḱ tana.
My husband is washing the car.	Ańaḱ Koa Car eć chapiê tana.
Are you tired?	Laga eanam?
You look very tired.	Esu laga akan gem neloḱ tana.
Don't lie!	Alam chakat́a!
Geography	Geography
Calm down.	Hapan ben.
Bounded by the Indian Ocean on the south, the Arabian Sea on the southwest, and the Bay of Bengal on the southeast, it shares land borders with Pakistan to the west; China, Nepal, and Bhutan to the north; and Bangladesh and Myanmar to the east.	South re Indian Ocean, southwest re Arabian Sea, southeast re Bay of Bengal menaḱa. West re Pakistan, North paa China, Nepal anḍoḱ Bhutan, east paa Bangladesh anḍoḱ Myanmar loḱ chirmit́ menaḱa. Indian Ocean ren Sri Lanka, Maldives naeć re menaḱa.
Can you help me?	Denga daeńaben chi?
A cat came out from under the desk.	Table latar aete Bilae ooḱl eana.
I don't want to go to school.	School kaa sen sukuń tana.
Russia is not the victim in its war on Ukraine.	Russiaren ko, Ukraine re takoaḱ War ren Victim ko do kaa.
Plato suggested applying the principles of selective breeding to humans around 400 BCE.	Human ko re selective breeding principle apply ê teaḱ do 400 BCE naaćnoḱ re Plato suggest led taekena.
Do you feel OK today?	Tisiṅ bugiben adaê tana chi?
How much does this cost?	Nena chimin gonoṅa?
I am at home every evening.	Jao Ayuṕ Oaḱ regeń taena.
He has since gained full speech abilities and has also twice competed in the Special Olympics for Uganda.	Imita aete ać do tayom, full Jagardanaeć eto ket́a, anḍoḱ Uganda lagit́ bar dao Special Olympics reóć compete let́a.
Is Tom awake?	Tom evn akanać chi?
I know you and Tom didn't do that together.	Tom loḱ misa te kaben paiṭi ket́a menteń adaana.
Driven by growth, India's nominal GDP per capita increased steadily from US$308 in 1991, when economic liberalisation began, to US$1,380 in 2010, to an estimated US$2,731 in 2024.	Growth te udur tersa akan India aḱ Nominal GDP Per Capita do, 1991 ren US$308 aete, 2010 ren US$1,380, anḍoḱ 2024 ren estimate akan US$2,731 jooṅ steadily increase hućoḱ akana.
The earliest known modern human remains in South Asia date to about 30,000 years ago.	South Asia ren earliest-known modern-human satareć ko reaḱ back-date do 30,000 sirma maaṅ daradari.
She doesn't want to be with anyone.	Jahć loḱó kaa taenn sukuć tana.
Raised by wolves.	Ṭẽoḱ ko hara maraṅ ken.
The East India Company's control of the seas, greater resources, and more advanced military training and technology led it to increasingly assert its military strength and caused it to become attractive to a portion of the Indian elite; these factors were crucial in allowing the company to gain control over the Bengal region by 1765 and sideline the other European companies.	Mughal ko, especially Akbar suba re, tribal bond anḍoḱ Islamic identity bage keet́, Persianised culture te near-divine status menaḱ tan emperor chetan re em len loyalty te, akoaḱ osar saniṅ ote chirmit́ ko unite ket́a.
The contemporary history of eugenics began in the late 19th century, when a popular eugenics movement emerged in the United Kingdom, and then spread to many countries, including the United States, Canada, Australia, and most European countries (e.g., Sweden and Germany).	Eugenics reaḱ Contemporary history do, 19th century aḱ United Kingdom re popular Eugenics movement unduṕ janeet́ United States,, Canada,, Australia,, goṭa noḱ European country (e.g., Sweden,, Germany) ko re nitir ean loḱ eṭeć eana.
Bacteria do not reproduce in alcohol.	Bacteria ko Alcohol re kakô hita posaoḱa.
Am I winning?	Daeoḱ tanań chi?
You've forgotten to tie your shoelaces.	Amaḱ Shoelace tolem riiń tat́a.
In the Punjab, Sikhism emerged, rejecting institutionalised religion.	Punjab re, institutionalised-religion reject ê tan Sikhism ooḱl eana.
I sat next to Tom.	Tom japaḱ reń duṕ lena.
Go along this street and turn right at the bank.	Nen Street rege sen akaa aete, Bank taḱ etom paa biurenn me.
Is it yours?	Ena abenaḱ chi?
Don't worry.	Alam uṛuḱoḱa.
"Once regarded as plants constituting the class Schizomycetes (""fission fungi""), bacteria are now classified as prokaryotes."	"Ayar kodo, Schizomycetes (""fission fungi"") Class ren Sińhita mente menoḱ taeken Bacteria ko do nahḱ Prokaryote mentekô classify akana."
The Thar Desert plays a crucial role in attracting the moisture-laden south-west summer monsoon winds that, between June and October, provide the majority of India's rainfall.	June aete October tala re India aḱ láḱpaa Gamadaḱ eém tan daḱpereć south-west aḱ Situṅdipili Monsoon Hoyo ko or aágu re, Thar Desert aḱ Crucial Role menaḱa.
It extends as far north as the Satpura and Vindhya ranges in central India.	Ena ge sangin utar do north re Satpura jooṅ anḍoḱ central re Vindhya range jooṅ sartal akana.
Guatemala City is the capital of Guatemala.	Guatemala City do Guatemala ren Capital.
According to a 2011 PricewaterhouseCoopers (PwC) report, India's GDP at purchasing power parity could overtake that of the United States by 2045.	2011 ren PricewaterhouseCoopers (PwC) report lekate, 2045 loḱ do, India aḱ Purchasing Power Parity te soṅoḱ GDP te United States aḱ ó parom láḱ daeoḱa.
I have a stomachache.	Láć hasuń tana.
I've never been to Istanbul.	Istanbul musiṅg ó kań senat́a.
He is from our village.	Ać do ale Hatu renić.
Eugenics (/juːˈdʒɛnɪks/ yoo-JEN-iks; from Ancient Greek εύ̃ (eû) 'good, well' and -γενής (genḗs) 'come into being, growing') is a set of beliefs and practices that aim to improve the genetic quality of a human population.	Eugenics (yoo-JEN-iks; Ancient Greek ren εύ̃ (eû) 'bugi, good, well', anḍoḱ -γενής (genḗs) 'unduboḱ, haraoḱ aete bai akana) do human population re genetic quality improve oḱ kâ menten belief anḍoḱ practice kokô metaà.
India has been a member of World Trade Organization since 1 January 1995.	1 January 1995 aete India do World Trade Organization ren Member lekate menaḱa.
Come dance!	Ela susun me!
Robert slowly walked back up to the door.	Rober mãe-mãe te Silpiń taḱć sen ruaa ket́a.
The United Nations commends Algeria for its unwavering commitment to promoting international peace and security through dialogue and urges all Member States to emulate Algeria's approach in seeking peaceful solutions to conflicts.	United Nations paaàete, Japagar Hora te International Peace anḍoḱ Security usa teérsa lagit́ Algeria ren koaḱ kaa ḍekot́oḱ Commitment, commend oḱ tana, anḍoḱ saben Member Disum ko, Algeria aḱ Approach kô eto otoṅêkâ mentekô kaji uduroḱ tana.
I am running in order to catch the train.	Train saṕ lagit́eń nir tana.
I am eating a banana.	Kadaleń jom tana.
Who lost their phone?	Phone okoe at́ ket́a?
Goodbye!	Bugi te senoḱ me!
Preserved by an oral tradition that was resolutely vigilant, the Rigveda records the dawning of Hinduism in India.	Resolutely-vigilant-oral-tradition te preserve len Rigveda re India re Hinduism reaḱ Aṅgèneoṕ record akana.
I've got a wife and kids.	Ań Hon Buḍi ko menaḱkoa.
The land became a village.	En Ote ge Hatu eana.
Shape.	Shape.
Tom freed Mary.	Tom Mary ć raa ket́ića.
Bacterial cells are about one-tenth the size of eukaryotic cells and are typically 0.5–5.0 micrometres in length.	Bacteria Jiwt́okoa koaḱ Size do, Eukaryote Jivt́okoa koaḱ one-tenth gea, anḍoḱ typically do 0.5–5.0 Micrometre jiliṅa.
I have two cats.	Ań taḱ barea Bilae kin menaḱa.
I just turned 20 and my younger sister will turn 13 next month.	Ań neège 20 sirmań hoba eana anḍoḱ Undińkui do hućoḱ chanḍuḱ 13 sirmać hobana.
You are in my heart today as always.	Jaoge leka tisiṅ oo ańaḱ Jibon re menaḱmea.
No matter how twisted the rope, it still breaks.	Bayar jah chimin patet́ akan reó, sit́oḱ gea.
How did you like Boston?	Boston chilikaben sukuat́a?
The octal numeral system uses the digits 0 to 7, and is the base-8 number system.	Octal Numeral System re 0 aete 7 jooṅaḱ Digit ko agujoṅoḱa, ena do Base-8 Number System.
The village has no electricity.	En Hatu re Electricity banoḱa.
I upgraded.	Upgrade ket́ań.
Tom probably won't be chosen.	Tom toraṅ kać salaoḱa.
Come and dance with me!	Ela ań loḱ susun me!
"Christian Gottfried Ehrenberg introduced the word ""bacterium"" in 1828."	"1828 re Christian Gottfried Ehrenberg ""Bacterium"" Kajihon eć introduce ket́a."
Indian climate is strongly influenced by the Himalayas and the Thar Desert, both of which drive the economically and culturally pivotal summer and winter monsoons.	India aḱ Climate do, economically,, culturally pivotal Situṅ,, Rabaṅdipiliaḱ Monsoon ko aágu tan Himalayburu anḍoḱ Thar Desert te strongly influence akana.
Show it to me.	Uduṕań me.
That's Tom's horse.	Enić Tom aḱ Sadom.
It was first described by David Dunning and Justin Kruger in 1999.	Ena ayar utar 1999 re Justin Kruger anḍoḱ David Dunning tekin describe let́ taekena.
Kalman entered the village.	Kalman Hatuć bolo eana.
Don't be like him.	Enić leka alam taena.
Am I suspected?	Ań re tómon menaḱ chi?
The principles of eugenics have been in practice since ancient Greece.	Eugenics reaḱ principle ko do ancient Greece period aete ge practice re menaḱa.
Per the London Declaration, India retained its membership of the Commonwealth, becoming the first republic within it.	London declaration lekate, India ren ko commonwealth reaḱ membership kô retain ket́a, enka te ena ren ayarutar Member kô bai eana.
I accuse the politicians of starting a war without plausible motive.	Politician ko, saári lekann Motive banoḱ tege Gopoćkô eṭeć ket́ reaḱń kaji chunḍulkô tana.
Western Sahara has phosphate.	West Sahara re Phosphate namoḱa.
Tom didn't want to come here yesterday.	Tom hola nentaḱ kać hućoḱ sanaṅ kena.
She is at home.	Oaḱ re menaḱća.
Numerous similar studies have been done.	Esu sangi similar study ko hoba akana.
What are you talking about?	Chenaḱpe jagarê tana?
Come dance!	Ela susun pe!
I asked Tom what he was reading.	Ać chenaḱć paṛao taekena mente Tom eń kuli ket́ića.
I don't think that Tom is still willing to do that.	Tom nahḱ ó enać paeṭi sanaṅ tan leka do kań adaêa.
What is your name?	Abenaḱ Nutum chenaḱa?
Those syringes had bacteria in them.	En Syringe ko re Bacteria ko tae kena.
Let's unearth the ginger.	Ada bu ur ooḱlêa dola.
Bacteria are important in sewage treatment and the breakdown of oil spills, the production of cheese and yogurt through fermentation, the recovery of gold, palladium, copper and other metals in the mining sector (biomining, bioleaching), as well as in biotechnology, and the manufacture of antibiotics and other chemicals.	Bacteria ko do, Sewage Treatment anḍoḱ Nur Sunum breakdown re,, Unuput́process te Cheese anḍoḱ Yogurt baái re,, Mining Sector re Samaom,, Palladium,, Copper anḍoḱ eṭaḱ Metal ko recovery re, Biotechnology re, anḍoḱ Antibiotics,, eṭaḱ Chemical ko baái reko important gea.
India is a nuclear-weapon state, which ranks high in military expenditure.	Military-expenditure re high-rank menaḱ tan India do nuclear-weapon-Disum tana.
The report highlights key growth factors: a young and rapidly growing working-age population; growth in the manufacturing sector because of rising education and engineering skill levels; and sustained growth of the consumer market driven by a rapidly growing middle-class.	En Report re Key Growth Factor ko highlight akana: young,, rapidly-growing Working-age Population; rise oḱ tan Education,, Engineering Skill Level te Manufacturing Sector ren Growth; anḍoḱ, rapidly-growing Middle-class ko te udur tersa akan Consumer Marker reaḱ sustained Growth.
Where are you going?	Okon tepea?
Goodbye!	Mar endo!
However, the country ranks 136th in the world in nominal GDP per capita and 125th in GDP per capita at PPP.	Enkareóge, Nominal GDP Per Capita lekate, India do 136 Rank re, anḍoḱ PPP re GDP Per Capita lekate 125 Rank re menaḱa.
I always work hard.	Ań jaoge Paeṭi reń lagatiṅ len gea.
During this time, pastoral peoples, whose land had been cleared to make way for the growing agricultural economy, were accommodated within caste society, as were new non-traditional ruling classes.	Nen time-period re, non-traditional ruling class ko leka ge, growing agricultural economy lagit́ hora bai re ote amiṅ ean pastoral people ko ó caste society reko accommodate eana.
I demand quality work.	Quality ann Paiṭiń asi tana.
Can I take a picture here?	Netaḱ koń photo baaêredo?
Most satellites, including the Hubble Space Telescope, orbit in a low Earth orbit of just a few hundred kilometers altitude.	Hubble Space Telescope misa keet́aḱ láḱpaa Telescope ko do, Altitude chiminaṅ ge kilometre hoban Suba Ote Orbit rekô biur sesena.
The concentration of carbon dioxide in the atmosphere has now reached 400 parts per million.	Atmosphere re Carbon Dioxide reaḱ Concentration do nahḱ 400 parts per million jooṅ beṭa eana.
Did you ask your father?	Apumem kuli ket́ića chi?
You are beautiful.	Esu bugipe neloḱa.
In 2022, India became the world's third-largest vehicle market after China and the United States, surpassing Japan.	In 2022, India became the world's third-largest vehicle market after China and the United States, surpassing Japan.
How do you say XXX in English?	XXX English te chenaḱpe metaà?
I like to dip a cookie in coffee.	Coffee re Cookie tupuê sukuńa.
Classical Sanskrit literature flowered as well, and Indian science, astronomy, medicine, and mathematics made significant advances.	Classical Sanskrit Literature ó hara sagen eana, India ren Science, Astronomy, Medicine, anḍoḱ Mathematics ko significantly advance eana.
Another criticism is that eugenics policies eventually lead to a loss of genetic diversity, thereby resulting in inbreeding depression due to a loss of genetic variation.	Eugenics policy kote do, eventually genetic diversity at́oḱa, entayom genetic variation at́oḱ te inbreeding depression beṭaoḱa mente ena reaḱ anḍoḱ miat́ Criticism menaḱa.
It is a pluralistic, multilingual and multi-ethnic society.	Nena do miat́ pluralistic, multilingual anḍoḱ multi-ethnic-society tana.
I want to cry.	Raḱ sukuń tana.
Tom and Mary said that they won't win.	Tom anḍoḱ Mary do 'Kakô daeoḱa' -mentekin kaji ket́a.
I am not married.	Kań aandi akana.
He walked to the house.	Oaḱć sen ket́a.
I have children.	Ańaḱ Hon ko menaḱkoa.
It's a Saxon village.	Ena do Saxon Hatu.
Look!	Nelê me!
As you say.	Am kajiê leka ge.
People from all over the world say that English is difficult to learn.	English etonn do esu muskila mente goṭa Ote ren ko kajiêa.
Averaging an economic growth rate of 7.5% for several years prior to 2007, India has more than doubled its hourly wage rates during the first decade of the 21st century.	2007 ayaraḱ chiminaṅ sirma ko Economic Growth Rate 7.5% average oḱ taeken India re, 21aḱ Century aáyar 10 sirma re, Hourly Wage Rate barsa biur aete ó láḱ akana.
Why do you say that?	Chenaḱ mente enkam kajiê tana?
Are you on Facebook?	Facebook re menaḱbena?
Their collective era was suffused with wide-ranging creativity, but also marked by the declining status of women, and the incorporation of untouchability into an organised system of belief.	Nekoaḱ collective Period do wide ranging Creativity te pereć lena, mendo Êra koaḱ Status decline anḍoḱ untouchability organised system of belief lekate incorporate ean teaḱ te ó urum lena.
The most recent common ancestor (MRCA) of bacteria and archaea was probably a hyperthermophile that lived about 2.5 billion–3.2 billion years ago.	Bacteria,, Archaea koaḱ Most Recent Common Ancestor (MRCA) do probably 2.5 Billion–3.2 Billion Serma noḱ maaṅ re taeken hyperthermophile.
It was colder yesterday than today.	Hola do Tisiṅ aeteó láḱ rabaṅ taekena.
The last person that I told my idea to thought that I was nuts.	Ańaḱ Idea koń kajiat́ić tayomdauaḱ hoo do 'ń baya tana' ć men ket́a.
Yet other scientific studies of feral children exist, such as the case of Genie.	Enreóge, Genie aḱ case lekan Birbagehon ko chetan eṭaḱ Scientific Study ko menaḱ gea.
Immediately south of the emerging Himalayas, plate movement created a vast crescent-shaped trough that rapidly filled with river-borne sediment and now constitutes the Indo-Gangetic Plain.	Rakaboḱ tan Himalay buru japaḱ rená south re, plate movement te maraṅ lekan cresent-shaped bahni bai eana, tayom do ena ãacha ge gaṛa atu agu let́ Sediment te pereć eana, ena te ge nahḱaḱ Indo-Gangetic Plain bai akana.
I have children.	Ańaḱ Hon kin menaḱkina.
I have a pen.	Ań taḱ miat́ Pen menaḱa.
Has that been scientifically proven?	Ena Science lekate uduṕ bit́ akana chi?
There was a time when we told each other everything.	Sabenaḱle japagar upuduṕ taeken miat́ Dipilaṅ ó taekena.
Who are you?	Okoe tanam?
People rightly criticize the villainous behavior of J.K. Rowling. If she didn't want to be criticized, she shouldn't have become a celebrity.	Hoo ko rightly ge J.K. Rowling aḱ Villian lekann Sepentapaekô umaa chunḍulêa. Umaa chunḍuloḱ teaḱ kać sanaṅ ken do honaṅ kać Celebrity yan teaḱ.
In the Indian Ocean, India is in the vicinity of Sri Lanka and the Maldives; its Andaman and Nicobar Islands share a maritime border with Thailand, Myanmar, and Indonesia.	India aḱ Andaman Nicobar Island koaḱ do Thailand, Myanmar, Indonesia loḱ maritime Chirmit́ menaḱa.
Why are they laughing?	Chenaḱ mentekô landa tana?
India's coastline measures 7,517 kilometres (4,700 mi) in length; of this distance, 5,423 kilometres (3,400 mi) belong to peninsular India and 2,094 kilometres (1,300 mi) to the Andaman, Nicobar, and Lakshadweep island chains.	India aḱ coastline do 7,517 kilometer jiliṅa; nen distance reaḱ 5,423 kilometre do peninsular India rea, anḍoḱ 2,094 kilometer do Andaman,, Nicobar,, Lakshadweep island-chain rea.
After the 10th century, Muslim Central Asian nomadic clans, using swift-horse cavalry and raising vast armies united by ethnicity and religion, repeatedly overran South Asia's north-western plains, leading eventually to the establishment of the Islamic Delhi Sultanate in 1206.	10th century tayom, ãacha-sadom cavalry anḍoḱ ethnicity religion te tolmit́ (unite) akan army ko te Central Asia ren nomadic Muslim clan ko, dao ge dao South Asia aḱ north-western plain ko attack yet́ taekena, ena ko te ge tayom 1206 re Islamic Delhi Sultanate establish eana.
I need a little help.	Joka Dengań dorkaroḱ tana.
Can you help me?	Denga daeńam chi?
They gathered in some villages.	Chiminaṅ Hatu rekô hunḍinn eana.
Tom wasn't crazy.	Tom kać baya lena.
What are you talking about?	Chenaḱben jagarê tana?
Subspecies of this bacteria are used as Lepidopteran-specific insecticides under trade names such as Dipel and Thuricide.	Nen Bacteria ren Subhita do Dipel,, Thuricide lekan Trade Name te Lepidopteran-specific Insecticide lekakô agujoṅoḱa.
They tickled Nuja.	Nuja kô guluṅ ket́ića.
In contemporary usage, the term eugenics is closely associated with scientific racism.	Contemporary usage re, Eugenics nen term do, scientific racism loḱ closely associate oḱa.
What happened?	Chika eana?
I am running.	Nir tanań.
This ensures the availability of the strain to scientists worldwide.	Neka te goṭa Otesae ren Scientist ko lagit́ en Strain available rika daeoḱa.
Are you all right?	Bugi gebena chi?
Mom will buy us a puppy.	Má Setahoneć kiriṅaliṅa.
Are you happy?	Rãasa rema chi kaa?
History	History
Tell her that I am in a taxi.	Taxi reńa mente kajiać me.
Sami covered his neck.	Sami taćaḱ Hoṭoḱć daloṕ ket́a.
Let's ask them.	Dolaṅ kulikoa.
Where is the tree?	En Daru do okon rea?
I hope we are the last.	Abu ge chanaṕaḱkôoḱkâń menea.
Let's ask her.	Dolabu kulića.
She is helping him.	Enić do aćeć denga tana.
I'm thirsty.	Daḱ tetaṅiń tana.
Algeria witnessed rapid economic growth during the Bouteflika era.	Bouteflika Era re, Algeria re Rapid Economic Growth hoba eana.
Adriano wandered into the village.	Adriano honor-honor te Hatuć bolo eana.
Hello, how are you?	Chige, chilika menaḱbena?
Lift it up.	Chetanê me.
On the Deccan Plateau, archaeological evidence from this period suggests the existence of a chiefdom stage of political organisation.	Deccan Plateau reaḱ nen period ren archaeological-evidence te inguloḱ tana chi nentaḱ re political-organisation reaḱ chiefdom-stage taekena mente.
Come and dance with me!	Dola ań loḱ susun ben!
The tornado destroyed the whole village.	Horlosi te goṭa Hatu raput́ chaba eana.
Jainism came into prominence during the life of its exemplar, Mahavira.	Jainism do ena ren exemplar Mahavira jiwt́ len re prominent ean taekena.
Important tributaries of the Ganges include the Yamuna and the Kosi; the latter's extremely low gradient, caused by long-term silt deposition, leads to severe floods and course changes.	Ganga gaṛaaḱ important Tributary ko re Yamuna,, Kosi ko lekaoḱa; sipirmaoḱge Tilat́ duṕ duṕ te hoba akan Kosi aḱ extremely-low-gradient te severe bán anḍoḱ gaṛa reaḱ Course change ko hobana.
Do you think Tom will reach the top of the mountain?	Alam har iriêća.
I know you're going to say no.	Adaanań kaagem menêa.
Come eat!	Ela jomê pe!
That's a nice village.	Ena esu bugi lekan Hatu.
I do not think that she is at home.	Oaḱ re menać leka do kań adaêa.
Mary gingerly lifted the creature out of the box and placed it on the floor.	Mary evn met́ akaa te en Jivt́ićeć tul rakaṕ ket́ića anḍoḱ Oaḱòte reć em ket́ića.
Shut up!	Hapann ben!
Simultaneously, the vast Tethyan oceanic crust, to its northeast, began to subduct under the Eurasian Plate.	Ena ko hoban tan imita ge, India aḱ northeast ren maraṅ lekan Tethyan oceanic crust do Eurasian Plate latar re subduct eṭeḱ eana.
He always wears black clothes.	Ać jaoge hende Lijaḱ kogeć tusiṅêa.
Pervasive and pernicious deviations from both fact and logical validity lurked behind a meretricious plausibility.	Fact anḍoḱ Logical Validity, banar aetenn nitir taáṕoḱ anḍoḱ maáura lekann Horabanage ko, pasáchaákat́ Plausibility danaṅ re uku akana.
The rights promised to Indians were granted slowly, but technological changes were introduced, and modern ideas of education and the public life took root.	India renko taḱ promise len rights ko do mãe mãe te em eana, mendo technological Change ko introduce eana, anḍoḱ education anḍoḱ public Life reaḱ modern Idea ko bit́ keṭeć eana.
Precisely!	Ena geda!
French surgeon Serge Aroles, however, has persuasively argued that the case was a fraud, perpetrated by Singh in order to raise money for his orphanage.	France ren Surgeon Serge Aroles mendo, en case do, Singh taćaḱ Orphanage lagit́ Funding harom aágu lagit́ uskur let́ Fraud mente persuasively ć argue akat́a.
Come dance!	Ela susun ben!
The Dravidian languages of India were supplanted in the northern and western regions.	India aḱ northern anḍoḱ western Region ko ren Dravidian language ko do supplant eana.
We are eating.	Jom tanalaṅ.
He always wears black clothes.	Enić jaoge hende Lijaḱ kogeć tusiṅêa.
What are you looking for?	Chenaḱpe nam tana?
As you say.	Ape kajiê leka ge.
India's telecommunication industry is the second-largest in the world with over 1.2 billion subscribers.	1.2 Billion Subscriber ko loḱ te, India aḱ Telecommunication Industry do Otesae baáraḱ-maraṅa.
We do not inherit the earth from our ancestors, we borrow it from our children.	Nen Ote do, Hapaam ko taḱ aete kabu tala namêa, Hon ko taḱ aetebu asi namêa.
Am I racist?	Racist geań chi?
That man looks like Tom.	En hoo Tom lekać neloḱa.
She'll probably tell him she's sleepy.	Duumiń tana' -menteć kajiaća toraṅ.
Is your blood pressure high?	Mayom Pressure tamm high gea chi?
I have a headache.	Bohḱ hasuń tana.
Are you all right?	Bugi gepea chi?
You have many books.	Am taḱ sange Kitaṕ ko menaḱa.
Marriage has a higher regret rate than gender-affirming care.	Gender-affirming Care reaḱ Regret Rate do Aandi reaḱ aeteó láḱa.
Do you have a car?	Am taḱ Car menaḱa?
Let's ask them.	Dolabu kulikina.
Biodiversity	Biodiversity
Can I take a picture of you?	Photo m redoń?
Are you on Facebook?	Facebook re menaḱpea?
What are you thinking about?	Chenaḱm uṛuḱoḱ tana?
Sami recommended Layla to the professor.	Sami Professor taḱ re Layla ć recommend ket́ića.
Does Tom know French?	Tom French eć adaana chi?
Are you married?	Aandi akanam?
Close the door.	Silpiń handet́ taa pe.
Man has many wishes that he does not really wish to fulfil, and it would be a misunderstanding to suppose the contrary. He wants them to remain wishes, they have value only in his imagination; their fulfilment would be a bitter disappointment to him. Such a desire is the desire for eternal life. If it were fulfilled, man would become thoroughly sick of living eternally, and yearn for death.	Sarite do kać asari sanaṅ lekan sange Sanaṅ koa hoo taḱ rea, nena reaḱ Sirkat́ ge suppose ê re ena do Misunderstanding ge menoḱa. En Sanaṅ ko Sanaṅ leka ge taeoḱkâć sanaṅa, enako aćaḱ Unuḍuḱ rege Gonoṅana; enako reaḱ Anasari do aćaḱ lagit́ heben-mér Dissapointment ge. Joroṅjinivt́ reaḱ Sanaṅ do miat́ enkan Sanaṅ ge. Ena sarioḱ redo honaṅ, hoo do joroṅ jivt́ teć malgeć utaroḱa, anḍoḱ Gonoćeć asi tangia.
He climbed to the peak of the mountain.	Butu Chuṭić deć rakaṕ eana.
You've gained weight.	Hambal eanam.
I don't know what year he was born.	Okon sirmać unduṕ lena kań adaana.
If throughout your life you abstain from murder, theft, fornication, perjury, blasphemy, and disrespect toward your parents, your church, and your king, you are conventionally held to deserve moral admiration even if you have never done a single kind or generous or useful action.	Goṭa Jinivt́ tamm Hoogoć,, Kumbuu,, Hapar,, Chanakat́ anḍoḱ amaḱ Engaàpu kinaḱ,, amaḱ Church reaḱ,, anḍoḱ amaḱ Rajaaḱ Disrespect aetem kaṭaṕenn redo, jah musiṅg ó miat́ kind chi generous chi useful teaḱ kam Paeṭi akat́ reó, convention lekate am do Moral Admiration emokoḱnić lekam lekaoḱa.
He refused any food given to him and died shortly after being found.	Aćkô emat́ Jomaḱ ko kaćaḱ eana anḍoḱ nam len tayom ge chimin singi aurioḱ regeć goć eana.
These included the consolidation and demarcation of sovereignty, the surveillance of the population, and the education of citizens.	Ena ko re sovereignty reaḱ consolidation anḍoḱ demarcation, hoo koaḱ surveillance anḍoḱ citizen koaḱ education ó mesa akana.
This village is mine!	Nena ańaḱ Hatu!
What does he do?	Chenaḱkin paiṭia.
We do not inherit the earth from our ancestors, we borrow it from our children.	Nen Ote, Hapaam ko taḱ aetebu tala namê teaḱ do káa, Hon ko taḱ aetebu asi teaḱa.
By the early 18th century, with the lines between commercial and political dominance being increasingly blurred, a number of European trading companies, including the English East India Company, had established coastal outposts.	18th century eteoṕ loḱ do, commercial anḍoḱ political dominance tala ren panaa gaar ẽeć tersaoḱ tan loḱ, English East India Company mesa keet́aḱ Europe aḱ sangi trading company ko patukam kuṭi (coastal) outpost kokô establish sekaa let́ taekena.
Yes.	É.
Look!	Nelê pe!
Is it yours?	Ena apeaḱ chi?
We need to find someone to help Tom.	Tom dengaćnićbu namić teaḱ menaḱa.
Do you have a cellphone?	Ape taḱ Cellphone menaḱa?
I don't have enough money to go to Boston.	Boston senoḱ imin Puisa banoḱa tań.
Why do people do bad things?	hoo ko chenaḱmente et́kanaḱkô paiṭiêa?
Yanni shot and missed his heart.	Yanni Surt́ taćć toḍe pocha ket́a.
India was then no longer exporting manufactured goods as it long had, but was instead supplying the British Empire with raw materials.	India aete anḍoḱ do sêdae re sipirmaoḱ ge taeken leka manufactured good ko do kaa export oḱ taekena, ena sati, British ko raw material ko supply oḱ taekena.
My family had already eaten dinner by the time I got home.	Oaḱń beṭaê loḱ do Oaḱ ren ko Dinner kô jom antaa let́a.
I like languages.	Eṭaḱ-eṭaḱ Jagar koń sukutea.
Come and dance with me!	Ela ań loḱ susun ben!
Back in high school, I got up at 6 a.m. every morning.	High School redo, jao Setaḱ 6 a.m. reń birit́ kena.
Prior to the 1600s, feral and wild children stories were usually limited to myths and legends.	1600 ko maaṅ do, Birbagehon koaḱ Story ko do usually Myth,, Legend ko jóṅ ge taekena.
The study of bacteria is known as bacteriology, a branch of microbiology.	Bacteria ko reaḱ Study do, Microbiology ren miat́ koto Bacteriology menoḱa.
Hindustan ([ɦɪndʊˈstaːn]) do 13th-century re popular len taeken India aḱ Middle-Persian Nutum, ena Mughal-Empire-period aete saben muli agu joṅo taekena.	Hindustan ([ɦɪndʊˈstaːn] ⓘ) is a Middle Persian name for India that became popular by the 13th century, and was used widely since the era of the Mughal Empire
The bus passed five minutes ago.	Bus do moe Minute ayar te parom eana.
Tom took out some coins and gave them to the old man.	Tom Coin koć onḍoṅ ket́a anḍoḱ en haam Hooć emat́a.
When the Chalukyas attempted to expand southwards, they were defeated by the Pallavas from farther south, who in turn were opposed by the Pandyas and the Cholas from still farther south.	Chalukya ko south paa teko expand lekead re anḍoḱ saniṅ south ren Pallava ko taḱaeteko haratiṅ eana, anḍoḱ neko ó anḍoḱ láḱ saniṅ south ren Pandya anḍoḱ Chola ko darom kedkoa.
Do you feel OK today?	Tisiṅ bugim adaê tana chi?
Are you guys Choctaw?	Ape Coktaw ko chi?
Bacteria (/bækˈtɪəriə/; sg.: bacterium) are ubiquitous, mostly free-living organisms often consisting of one biological cell.	Bacteria ko (/bækˈtɪəriə/; sg.: bacterium) do, often miat́ ge biological Jivt́okoaann (Cell), ubiquitous,, sangepaa do free-living Organism ko.
The ancient Romans called this day the Ides of May.	Ancient Roman ko nen Musiṅg 'Ides of May' kô metat́a.
I've visited the village.	En Hatuń sen akana.
"I found one day in school a boy of medium size ill-treating a smaller boy. I expostulated, but he replied: ""The bigs hit me, so I hit the babies; that's fair."" In these words he epitomized the history of the human race."	"Musiṅg School re miat́ tala Mataraṅ ren Koahon miat́ huḍiṅ noḱ genn Koahoneć sasatieć tan geń nam let́ića. Peeć teń kaji darom ket́ića, mendo ać kaji uraa ket́a: ""Maraṅ ko rúńa, enamente Huḍiṅhon koń rúkôa; nena do fair gea."" Ać nen Kaji re ge, Human Race reaḱ History ć sagom tol ket́a."
I am in Tokyo today.	Tisiṅ Tokyo re menaḱńa.
India's defining geological processes began 75 million years ago when the Indian Plate, then part of the southern supercontinent Gondwana, began a north-eastward drift caused by seafloor spreading to its south-west, and later, south and south-east.	India aḱ defining geological process ko do, 75 million sirma maaṅ re, en imita southern supercontinent Gondawana aḱ part taeken Indian Plate, seafloor south-west paa te, anḍoḱ tayom ko do south,, south-east paa te udur aguoḱ tan te north-east paa te usa eoṕ ean re eoṕ lena.
I run quickly.	Ãachań nir daea.
She's shouting your name.	Amaḱ Nutumeć iuê tana.
Why are you angry?	Chikatem rágo akana?
Everything is going well.	Sabenaḱ bugin ge sesen tana.
In the 15th century, the Vijayanagara Empire created a long-lasting composite Hindu culture in south India.	15th-century re, Vijayanagara-Empire renko south-India re long-lasting-composite-Hindu-culture ko bai ket́a.
Are you in London?	London remea chi?
Show me again.	anḍoḱ misa uduṕań ben.
Ziri got no response.	Ziri do Telakaji kać nam ket́a.
Until 1991, all Indian governments followed protectionist policies that were influenced by socialist economics.	1991 jooṅ do, sanam India aḱ Government ko, Socialist Economy ko te influence len Protectionist Policy ko saṕ otoṅ let́a.
Claudio was driving a dark blue car.	Claudio do dark blue Car eć har let́ taekena.
How are you?	Chilika menaḱbena?
According to the Worldwide Cost of Living Report 2017 released by the Economist Intelligence Unit (EIU) which was created by comparing more than 400 individual prices across 160 products and services, four of the cheapest cities were in India: Bangalore (3rd), Mumbai (5th), Chennai (5th) and New Delhi (8th).	160 Product anḍoḱ Service ko tala re 400 aete ó láḱ Individual Price ko umaa keet́ bai len,, Economist Intelligence Unit (EIU) paa aete release len 2017 Worldwide Cost of Living Report lekate, Cheapest City ko re upunea do India rege taekena: Bangalore (3aḱ), Mumbai (5aḱ), Chennai (5aḱ) and New Delhi (8aḱ).
Do you have a car?	Ape taḱ Car menaḱa?
Where did she learn to sing the blues?	Blues do okon reć duraṅ eto ket́a?
Do you want to help?	Dengańape?
Are you Japanese?	Japan ren ko tanape?
The second boy (1341) resisted capture, biting and scratching; he continued to run on all four limbs and hid under a bench.	Second Koahon do (1341), ká saṕ ichinneć nam kena, huaḱ gotaḱ kenać, otetí akan te geć nir baa kena anḍoḱ Bench suba reć ukunn eana.
Show me again.	anḍoḱ misa uduṕań pe.
To the south, the remaining peninsular landmass, the Deccan Plateau, is flanked on the west and east by coastal ranges known as the Western and Eastern Ghats; the plateau contains the country's oldest rock formations, some over one billion years old.	South re, sareć akan pensular landmass Deccan Plateau do, west,, east re, Western,, Eastern Ghats menoḱ coastal range te aṭangi akana; en plateau re nen disum aḱ mariutar sereṅ formation ko menaḱa, ena re chiminaṅ do mit́ billion sirma maria.
Why are you sad?	Chikateben duku akana?
You aren't a carpenter, are you?	Am do Carpenter káa, kachia?
Proclaiming a unitary state and a gradual but limited British-style parliamentary system, the new rulers also protected princes and landed gentry as a feudal safeguard against future unrest.	Unitary state anḍoḱ mãe mãe te limited British parliament system proclaim keet́, nen nama ruler ko prince anḍoḱ ote hasa an land gentry ko kapalomaḱ unrest aeten safeguard leka ko protect ledkôa.
Look over there.	Haneè!
Stop!	Hokaê pe!
Furthermore, many criticize negative eugenics in particular as a violation of basic human rights, seen since 1968's Proclamation of Tehran, as including the right to reproduce.	Furthermore, 1968 aḱ Tehran Proclamation tayom, basic human rights re reproduction reaḱ right ó menaḱ gea mente nel ean te, sangê hoo ko negative Eugenics do ena reaḱ violation tana mentekô criticise ket́a.
Who's on duty tonight?	Tisiṅg Nida okoć Duty reića?
What do you know about dogs?	Seta ko reaḱ chenaḱm adaana?
In 2005 he was killed in a fire.	2005 re, Sengel teć ló goć eana.
My sister has ginger hair.	Unḍińkuiaḱ Bohḱbale araḱ chambaraà.
Do you think Tom will reach the top of the mountain?	Tom do Buruchuṭić beṭaê lekam adaê tana?
Everyone charged with a penal offence has the right to be presumed innocent until proved guilty according to law in a public trial at which he has had all the guarantees necessary for his defence.	Penal Offense te charge akan saben ko ge, takoaḱ Defence lagit́ asitińoḱ saben Guarantee em yan Public Trial re, Law lekate Guilty aurikô uduṕbit́oḱ jooṅ, Innocent mente nelmenoḱ teaḱ Right menaḱa.
I like you.	Amań sukua tana.
Say it again.	anḍoḱ misa kajiêpe.
Do what is good to those who hate you.	Kaa bugiben tan koó bugiko ben.
Ziri was the village hero.	Ziri Hatu ren Hero lenać.
If you live at a higher altitude, water boils at a lower temperature.	Chetan noḱ Altitude rem taenn redo, Daḱ latar noḱ Temperature re basaṅoḱa.
In the Indian Ocean, India is in the vicinity of Sri Lanka and the Maldives; its Andaman and Nicobar Islands share a maritime border with Thailand, Myanmar, and Indonesia.	India aḱ Andaman Nicobar Island koaḱ do Thailand, Myanmar, Indonesia loḱ maritime Chirmit́ menaḱa.
Buddhism, based on the teachings of Gautama Buddha, attracted followers from all social classes excepting the middle class; chronicling the life of the Buddha was central to the beginnings of recorded history in India.	Gautama Buddha aḱ teaching chetan bit́ akan Buddhism paa te, middle-class bage keet́ saben social-class ren ko or idi len taekena; Buddha aḱ life reaḱ chronicling do India aḱ recorded-history reaḱ eneoṕ re central Role taekena.
I am in Tokyo today.	Tisiṅ Tokyo reńa.
Hello!	Chige!
The Indian early medieval age, from 600 to 1200 CE, is defined by regional kingdoms and cultural diversity.	600 aete 1200 CE, India aḱ Early Medieval Age do, regional kingdom ko anḍoḱ cultural diversity te nutum len taekena.
Around the 20th century, psychologists were attempting to differentiate between biological behavior and culture.	20th century naaćpaa, Psychologist ko Biological Behaviour anḍoḱ Culture urumsapaniṅê teaḱkô attempt let́a.
They brought umbrellas.	Chatom kokô agu ket́a.
Are you awake?	Evn akanam?
May I smoke here?	Nentaḱ reń moḱsiṕ redo?
It isn't gold.	Ena Samaom do kaa.
Come and dance with me!	Ela ań loḱ susun pe!
There's no scientific explanation for this.	Nena reaḱ jahn Science lekatenn Explanation banoḱa.
The adoption of progressive policies to mitigate climate change impacts and promote renewable energy underscores Algeria's commitment to global environmental stewardship.	Climate Change reaḱ Etelaṅ ko adit́ raábal anḍoḱ Namaruaadaeoḱ Energy udur teérsa Policy ko reaḱ Agusanaṕ te, Otesai Environment Stewardship lagit́ tenn Algeria aḱ Commitment uduṕ chetanoḱ tana.
"Most bacterial species exist as single cells; others associate in characteristic patterns: Neisseria forms diploids (pairs), streptococci form chains, and staphylococci group together in ""bunch of grapes"" clusters."	"Láḱpaa Bacteriahita do Single Cell lekakô taena; eṭaḱ ko do Characteristic Pattern ko rekô jumurena: Neisseria do Diploid (Jimki) kô baina, Streptococci do Sinkii kô baina, anḍoḱ Staphylococci do ""Ićtayar Rumpa"" lekakô hunḍina."
Modern India	Modern India
You can't retire yet.	Kam retire daea auri.
Antonio was nearly caught by his wife.	Antonio do Êra taḱć saṕ choṭeć eana.
Why are you dancing?	Chikatem susun tana?
No mountain in Japan is higher than Mt. Fuji.	Japan ren jahn Buru ó Fuji Buru aete ká usula.
Do you speak English?	English ben jagar adaana?
Why are you angry?	Chikatepe kurkur akana?
Are you all right?	Bugi gema chi?
The question was taken seriously as science tried to name and categorize the development of humans, and the understanding of the natural world in the 18th and 19th century.	18th,, 19th century re Science re Hooharamanaraṅ (human development) nutumê anḍoḱ haṭińòkoaê (categorize) teaḱ,, Natural World munḍiê teaḱ attempt taeken loḱ, nen Kunuli do seriously ataṅ ean taekena.
If language input does not occur until after this time, the individual will never achieve a full command of language.	Language Emànader nen Period tayom enaṅ hoban redo, enić Language reaḱ full command jaa musiṅ ó kać achieve renáêa.
Act like adults.	Maraṅ ko leka taenn pe.
I am at home.	Oaḱ re menaḱńa.
I personally believe that U.S. Americans are unable to do so because, uh, some people out there in our nation don't have maps and, uh, I believe that our, uh, education like such as in South Africa and, uh, the Iraq, everywhere like such as, and, I believe that they should, our education over here in the U.S. should help the U.S., uh, or, uh, should help South Africa and should help the Iraq and the Asian countries, so we will be able to build up our future, for our children.	Ań eskar reaḱ uḍuḱ lekate, U.S. American ko kakô enka daea, enado, ââ, abu Disum re menaḱkô chiminaṅ hoo ko taḱ Map ko banoḱ te, anḍoḱ, ââ, ańaḱ uḍuḱ lekate, abuaḱ, ââ, Education, South Africa re leka, anḍoḱ, ââ, Iraq, enka sabentaḱ re leka, anḍoḱ, ańaḱ uḍuḱ lekate, ako do honaṅ, abu nentaḱ U.S. reaḱ Education te do U.S. ren ko ge dengaoḱ teaḱ ge, ââ, baredo, ââ, South Africa ren ko dengaoḱ teaḱ ge, anḍoḱ, Iraq ren ko dengaoḱ teaḱ ge, anḍoḱ eṭaḱ Asia aḱ Disum ko dengaoḱ teaḱ ge, enate, abuaḱ Hon ko lagit́ abuaḱ Kanalombu bai rakaṕ daea.
They have nothing left.	Akin taḱ Jahnaḱ kaa sareć akana.
Thank you!	Bithiyem!
The earliest life on land may have been bacteria some 3.22 billion years ago.	Hasaòte ren ayarùtar Jinivt́ do, 3.22 Billion Serma noḱ maaṅ re taeken Bacteria koge toraṅ.
I gagged.	Ulaê lekań rika eana.
Do you know what the differences between emoticons and emojis are?	Emoticon anḍoḱ Emoji tala reaḱ Sapaniń dom adaana chi?
How long have you been here for?	Nentaḱ chimin sirma aeteben taenn tana?
It has disputes over Kashmir with its neighbours, Pakistan and China, unresolved since the mid-20th century.	Neighbour ren Pakistan anḍoḱ China loḱ 20th century aete unresolve akan Kashmir reaḱ dispute menaḱ akat́ gea.
Instead of going into a care facility, he went to live with vervet monkeys.	Care Facility te senoḱ sati, Vervet Gai ko loḱ taeneć senoḱ eana.
Father is waiting.	Apu tangi tanać.
That's easy to explain.	Ena do lavar te explain daeoḱa.
Is that what Yanni wants?	Yanni do ena geć sanaṅ tana chi?
Look at this.	Neè nelê pe.
They are even found in the atmosphere and one cubic metre of air holds around one hundred million bacterial cells.	Enko do, Hoyopai (Atmosphere) reó menaḱkôa, mit́ cubic metre Hoyo re mit́ Hundred Million leka Bacteria Jivt́okoa ko taena.
Tom broke something again.	Tom onḍoḱ ge chenaḱ koć raput́ ket́a.
Let's ask them.	Dolabu kulikoa.
Where are you from?	Am okon renić?
I miss the village.	Hatu paa esu uḍuḱńa.
Did you buy the pomegranate juice?	Pomegranate Rasim kiriṅ ket́a chi?
The most common fatal bacterial diseases are respiratory infections.	Most common goóć Bacteriarua (Bacterial Diseases) kodo Saet́hora Chaálrua (Respiratory Infections) ko.
From being a comparatively destitute country in 1951, India has become a fast-growing major economy and a hub for information technology services, with an expanding middle class.	1951 sirma ren miat́ comparatively ringâ-rengeć disum aete, India do nahḱ ãacha tersaoḱ tan major-economy anḍoḱ osaroḱ tan middle-class menaḱ Information Technology Service ren Hub akana.
Where is your father?	Abenaḱ Baṅ tekin okon rekina?
Tom was very scared.	Tom esuć boro let́a.
No ruler of this period was able to create an empire and consistently control lands much beyond their core region.	Nen period ren jaan ruler ko ó empire bai keet́ akoaḱ core Region aete láḱ ote consistantly kakô control daeada.
The world is a village.	Nen Otesae do miat́ Hatu.
"Such programs included both positive measures, such as encouraging individuals deemed particularly ""fit"" to reproduce, and negative measures, such as marriage prohibitions and forced sterilization of people deemed unfit for reproduction."	"Enkan program ko re, reproduction lagit́ particularly ""fit"" ge nel ean ko encourage ko lekan positive measure ko ó taekena anḍoḱ reproduction lagit́ unfit ge nel ean koaḱ forced sterilisation,, marriage prohibition ó taekena."
An initial medical examination conducted in September showed the elephant’s nails had cracked and were overgrown due to improper care and an insufficient enclosure with flooring that damaged its feet.	Ká proper ann Nelsapaṕ te, anḍoḱ Kaṭa tać damage ê tan ká soóṕ Eneset́pai te, Hatiaḱ Sarsar chaṭaḱ len taekena, anḍoḱ hara láḱ lena, -mente, September re rika len Initial Medical Examination te uduṕ marsal eana.
Leave me alone!	Bage tań me!
Time has no divisions to mark its passage, there is never a thunderstorm or blare of trumpets to announce the beginning of a new month or year. Even when a new century begins it is only we mortals who ring bells and fire off pistols.	Time reaḱ Panarom bal rikaê lagit́ ena rege do jah lekan Hanaṭiń Gár ko banoḱa, nama chanḍuḱ baredo nama sirma reaḱ Eneṭeć ḍakaraê lagit́ musiṅg ó Hoyohichir chi Trumpet reaḱ pẽ́t́-pẽ́t́ do ká hobana. Miat́ nama Century eṭećoḱ reó ge, abu Hasa subaoḱ hoo ko sekar Ṭinṭinaḱ kobu saḍiêa,, Pistol kobu ṭulêa.
Let's work.	Dolabu paitiêa.
Mom is going to town.	Má Town eć senoḱ tana.
He burned the village.	Haruć uruṕ ket́a.
Very dense forest, whose canopy density is greater than 70%, occupies 3.02% of India's land area.	Daruhuṉulsuṕìnibil (canopy density) 70% aete láḱann very dense forest do, India Otebinilaḱ 3.02% hobaoḱa.
Tom is busy now, so he can't talk with you.	Tom nahḱ Paiṭi rića, am loḱ kać jagar daea.
Nancy looks so tired.	Nancy do esu laga akan geć neloḱ tana.
Look here.	Nepaa nelê pe.
Am I eligible?	Eligible geań chi?
Why didn't you run?	Chenaḱ mente kam nir ket́a?
You danced.	Susun kenaben.
Bacteria can also group to form larger multicellular structures, such as the elongated filaments of Actinomycetota species, the aggregates of Myxobacteria species, and the complex hyphae of Streptomyces species.	Bacteria do Actinomycetota Hita koaḱ jiliṅ Filament, Myxobacteria Hita koaḱ Aggregate, anḍoḱ Streptomyces Hita koaḱ Complex Hyphae leka láḱ maraṅ Multicellular Structure ókô bai daea.
I know you are struggling.	Kurumuṭunn tanapeń adaana.
The sultanate was to control much of North India and to make many forays into South India.	En Sultanate te ge goṭa noḱ North India control lena, anḍoḱ ena te ge South India chetan te sangi dao attack hoba lena.
Bring oil and turmeric.	Sunum,, Sasaṅ aguê me.
I'll probably get fired if I don't do that.	Nena kań paeṭiê rekô har enḍaḱńa toraṅ.
Tom should've talked to Mary.	Tom do Mary ić jagar kat́ić teaḱ ge honaṅ.
Tom cussed.	Tom mage ket́ać.
Bacteria also live in mutualistic, commensal and parasitic relationships with plants and animals.	Bacteria kodo, Sińjivt́ (Plants) anḍoḱ Senêjivt́ (Animals) ko loḱ mutualistic,, commensal,, parasitic Relationship reókô taena.
The impaired ability to learn a natural language after having been isolated for so many years is often attributed to the existence of a critical period for language learning, and taken as evidence in favor of the critical period hypothesis.	Esu sirma tannga sangin len taeken te, Naturaljagar Etondanae impair janaḱ lagit́ do, often Jagarèneto reaḱ critical period menaḱ menteaḱ ge Reason menoḱa, anḍoḱ ena ge Critical Period Hypothesis lagit́aḱ Evidence lekate uduḱ joṅoḱa.
I cried reading this book.	Nen Kitab paṛaoket́ teń raḱ ket́a.
In an age of increasing urban wealth, both religions held up renunciation as an ideal, and both established long-lasting monastic traditions.	Urban wealth saaroḱ tan time Period re, nen barea religion re renunciation ge ideal mente rikâ lena, anḍoḱ en barea rege long-lasting monastic Tradition establish eana.
According to the metacognitive explanation, poor performers misjudge their abilities because they fail to recognize the qualitative difference between their performances and the performances of others.	Metacognitive explanation lekate, poor performer ko, takoaḱ performance oḍoḱ eṭaḱ koaḱ performance tala ren qualitative sapaniṅ kakô urum dae te, takoaḱ ability kô misjudge êa.
They often seem mentally impaired and have almost insurmountable trouble learning a human language.	Enko often Hataṅimpair akan ge ko neloḱa, anḍoḱ, Hoojanagar (human language) eton re káparomdaeoḱ noḱ trouble taena.
Although at first disruptive for the Indian elites, the sultanate largely left its vast non-Muslim subject population to its own laws and customs.	Although at first disruptive for the Indian elites, the sultanate largely left its vast non-Muslim subject population to its own laws and customs.
Have you washed the dishes?	Bela kom gasar ket́a chi?
Let's divide the check between us.	Cheque do bar Hoo relaṅ haṭinêa.
How did you like Boston?	Boston chilikape sukuat́a?
I want to run.	Nir sukuń tana.
Why are you angry?	Chikatepe rágo akana?
Bacteria are microorganisms.	Bacteria do Manjivt́ ko.
I am not married yet.	Kań aandi akan gea.
Tom said he wanted to play tennis this morning.	Tom tisiṅ Setaḱ Tennis inuṅ sanaṅiń tanać men ket́a.
This book will never be published again.	Nen Sapagom do anḍoḱ jahchiula ó ká publish oḱa.
History of bacteriology.	Bacteriology reaḱ History.
Leave me alone!	Bage tań ben!
There are thought to be approximately 2×1030 bacteria on Earth, forming a biomass that is only exceeded by plants.	Siń ko sekar láḱ parom akaat́ Biomass baái nen Bacteria ko, Ote chetan approximately 2×1030 menaḱkôa mente leka bai akana.
How far is the village?	Hatu chimin saniṅa?
"In the Netherlands, it is the custom that, when during the construction of a house the highest point has been reached and the roof is ready for tiling, the client treats the construction workers to so-called ""tile beer"" to celebrate this. A flag is then placed on the ridge of the house. If the client is too stingy to treat, not a flag, but a broom is placed."	"Netherlands re, Oaḱ baioḱ tan re, Chuṭi jooṅ bai beṭa yan aete Saṛima do Kechoḱ te daṕoḱ leka taen re, ena celebrate lagit́, Client, nutumènkan ""tile beer"" nú te Construction Worker koć keaakô teaḱ Custom menaḱa. Enaete Oaḱjangi re miat́ Hoyolijaḱ bit́oḱa. Client esuć kuṭu ge redo, Hoyolijaḱ ká, Jonoḱ bit́oḱa."
In the Punjab, Sikhism emerged, rejecting institutionalised religion.	Punjab re, institutionalised-religion reject ê tan Sikhism ooḱl eana.
Are you Japanese?	Japan ren kin tanaben?
I sell land.	Oteń akarińa.
Between 2001 and 2011, the contribution of petrochemical and engineering goods to total exports grew from 14% to 42%.	2001 aete 2011 sirma tala re, Total Export re Dirisunumchemical (Petrochemical) anḍoḱ Engineering Goods koaḱ Share do 14% aete 42% jooṅ láḱ beṭa eana.
Your sentences are the only ones which should be translated on this site.	Nen Site re translate oḱ teaḱ ge do amaḱ Sentence ko sekar.
Santali is the third most-spoken Austroasiatic language after Vietnamese and Khmer.	Santali do, Vietnamese,, Khmer tayom, apéaḱ sangeùtar jagaroḱ Austroasiatic Janagar.
We are in the same class.	Miad Class rege menaḱbua.
The critical period hypothesis is derived from the concept of a critical period in the biological sciences, which refers to a set period in which an organism must acquire a skill or ability, or said organism will not be able to acquire it later in life.	Critical Period Hypothesis do, jahn Organism reó, miat́ Set Period loḱ jahn Skill,, Danaeć eton te hobana, baredo tayomaḱ Taesirma ko kać eto daea menten Biological Sciences ren Critical Period Concept aete derive akana.
Viruses are much smaller than bacteria.	Virus ko do Bacteria aete ó esu renákô huḍińa.
Do you feel OK today?	Tisiṅ bugipe adaê tana chi?
Major exports include petroleum products, textile goods, jewellery, software, engineering goods, chemicals, and manufactured leather goods.	Major Exportaḱ kore, Dirisunum Product, Textile Goods, Jewellery, Software, Engineering Goods, Chemical anḍoḱ Manufactured Leather Goods leka mesaoḱa.
You are in my way.	Ańaḱ Hora re menaḱmea.
He said that he was relaxed.	Ruu akanać menteć kaji ket́a.
It is a village.	Ena do miat́ Hatu.
I'm all worn out.	Laga chaba akanań.
Climate change in India is often thought to be the cause.	Ena reaḱ Cause do India ren Climate Change ge mente often menoḱa.
I've always wondered what it'd be like to have siblings.	Unḍi-Boko ko taenn re chilikaà toraṅ -mente jaogeń uḍuḱ baa akat́a.
The Mughal Empire, in 1526, ushered in two centuries of relative peace, leaving a legacy of luminous architecture.	1526 re Mughal Empire iate 2-century relative-peace agu eana, anḍoḱ luminous-architecture reaḱ legacy bagetúê eana.
Tom has committed suicide.	Tom doć goćenn eana.
She lives in this village.	Nen Hatu reć taena.
Its further access to the riches of Bengal and the subsequent increased strength and size of its army enabled it to annex or subdue most of India by the 1820s.	Bengal aḱ biti reaḱ anḍoḱ láḱ access, anḍoḱ en tayomaḱ peeć anḍoḱ army size re lanahḱ te láḱpaa India annex baredo subdue ć dae eana.
Crush the ginger.	Ada sert́ê me.
Settled life emerged on the subcontinent in the western margins of the Indus river basin 9,000 years ago, evolving gradually into the Indus Valley Civilisation of the third millennium BCE.	9,000 sirma maaṅ Sindhu Gaḍa Basin western Kuṭi re settled-life nelnam eana, ena ge tayom mae-mae te 3000 BCE re Indus Valley Civilization baioḱge evolve eana.
Did you let Tom rest?	Tom dom jirao iri ket́ića?
How do you say XXX in English?	XXX, nena English te chilikakô menea?
Show it to me.	Uduṕań ben.
What are you eating?	Chenaḱben jom tana?
Lift it up.	Chetanê ben.
Why are you sad?	Chikatepe duku akana?
Walk gingerly.	Evn met́ akaa te senê me.
Are you a student?	Paṛao tanape?
It is the seventh-largest country by area; the most populous country as of June 2023; and from the time of its independence in 1947, the world's most populous democracy.	June 2023 jooṅ re nena do Area lekate 7 aḱ maraṅ disum; anḍoḱ saben ko aete láḱ population an disum tana; anḍoḱ 1947 sirma re independence aete nena do world reaḱ saben aete láḱ population an democracy tana.
Check if the gas tap is closed.	Gas reaḱ Tap do eset́ akana chi nel lekaa me.
I can count.	Leka daeań.
I don't know.	Kań adaana.
Sami was feigning memory loss.	Sami do Memory at́ ket́ lekać uduṕ chakat́enn taekena.
Smile.	Landaê ben.
What would you like to eat?	Chenaḱben jomêa?
Lift it up.	Tíṅê pe.
Kabylie has many beautiful villages.	Kabylie re sange móć-móć Hatu ko menaḱa.
Why are you laughing?	Chenaḱ menteben landaê tana?
Fed by diverse resentments and perceptions, including invasive British-style social reforms, harsh land taxes, and summary treatment of some rich landowners and princes, the rebellion rocked many regions of northern and central India and shook the foundations of Company rule.	Invasive gen British-style social reform, harsh land tax, chiminaṅ landowner anḍoḱ prince ko summary ge treat ket́ ko teaḱ ko mesa keet́aḱ diverse resentment anḍoḱ perception te ajom hara len nen rebellion te do northern anḍoḱ central India ren sangi Region ko ituṅ eana anḍoḱ Company rule ren foundation ekela eana.
She did it on purpose.	Adaan aeteć enka ket́a.
The resulting Mughal Empire did not stamp out the local societies it came to rule.	Enaaḱ result te bai ean Mughal Empire re, rule suba ean local society ko ẽeć do kakô ẽeć muchat́ eana.
Where does it hurt?	Okontaḱ hasum tana?
I like running.	Nir sukuńa.
I'll make beans for you.	Rambaań isinamea.
Why are you sad?	Chikatem duku akana?
It tastes very sweet.	Esu nogot́ ge jomoḱa.
Settled life emerged on the subcontinent in the western margins of the Indus river basin 9,000 years ago, evolving gradually into the Indus Valley Civilisation of the third millennium BCE.	9,000 sirma maaṅ Sindhu-river-basin western kuṭi re settled-life nelnam eana, ena ge tayom mãe mãe te 3000 BCE re Indus-Valley-Civilization baioḱge evolve eana.
Their village is small.	Hatu takin huḍiń gea.
It's scientifically proven.	Science lekate uduṕ bit́ akana.
There was an increase in the number of large-scale famines, and, despite the risks of infrastructure development borne by Indian taxpayers, little industrial employment was generated for Indians.	Maraṅ-scale ringâ ko reaḱ leneka láḱ eana, anḍoḱ do, infrastructure development reaḱ risk India ren taxpayer ko chetan re taeken re ó, India ren ko lagit́ esu kom industrial employment generate ean taekena.
Salas and Silya didn't tell me that you were a doctor.	Doctor akanam -mente Salas anḍoḱ Silya kakin kajiat́ińa.
Can you tell me why?	Chenaḱmenteaḱm kaji daeańa?
These multicellular structures are often only seen in certain conditions.	Nen Multicellular Structure ko do often chelekan Condition rege nel namoḱa.
Do you want to sleep?	Gitićape?
Where do you live?	Okon rem taena?
Have you seen this man?	Nen Hoom nelat́ića?
Don't lie.	Alaben chakat́a.
I know you are struggling.	Kurumuṭunnn tanameń adaana.
Most bacterial species are either spherical, called cocci (singular coccus, from Greek kókkos, grain, seed), or rod-shaped, called bacilli (sing. bacillus, from Latin baculus, stick).	Láḱpaa Bacteriahita dokô ḍumaṅ (spherical) gea, cocci kô menoḱa (singular do coccus, Greek reaḱ kókkos, Gele, Hitajaṅ aete), baredokô Rod-shape gea, bacilli kô menoḱa (singular do bacillus, Latin reaḱ baculus, Jaṭa aete).
Stay awake.	Evn akanoḱ pe.
Look!	Nelê ben!
Come with me.	Hućoḱ me ań loḱ.
He got to his village.	Aćaḱ Hatuć tebaḱ ket́a.
I don't know when I will return.	Chuilań ruaaà kań adaana.
Medieval India	Medieval India
Vital to India's self-image as an independent nation was its constitution, completed in 1950, which put in place a secular and democratic republic.	Independent nation lekate India aḱ self-image baioḱ lagit́ do, secular anḍoḱ democratic republic bit́ ken, 1950 re sekaa jan, India aḱ constitution aḱ vital role taekena.
I am eating lunch with my sister.	Undińkui loḱń basiamenn tana.
I eat fish every week.	Jao Háṭ Haku Jiluń joma.
Calm down.	Hapan me.
Tell me again.	anḍoḱ misa kajiań ben.
In South India, the Middle kingdoms exported Dravidian-languages scripts and religious cultures to the kingdoms of Southeast Asia.	South-India re, Middle-kingdom ko Southeast-Asia ren kingdom ko paa te Dravidian-language-script ko anḍoḱ religious-culture kokô export ket́a.
Indian movies, music, and spiritual teachings play an increasing role in global culture.	Indian-movie, music, spiritual-teaching ko do global Culture re increasing Role menaḱa.
She smiled sadly.	Duku teć landa ket́a.
Far better it is to dare mighty things, to win glorious triumphs even though checkered by failure, than to rank with those poor spirits who neither enjoy nor suffer much because they live in the gray twilight that knows neither victory nor defeat.	Usul maraṅaḱ ko borsa teaḱ,, Panaḍu te bal pereć akan reó nuútum lekan Danae ko daeoḱ teaḱ do, en Danae ó Panaḍu ó ká urumoḱ lekan toroć Ayuṕ re taen-taen te Rãasa ó Duku ó ká namê lekan Rva ko bapui loḱ leka mesann teaḱ aete láḱ te rená bugina.
Come with me.	Hućoḱ ben ań loḱ.
What makes you think that it was Tom who did this?	Ena do Tom ge enka ket́a mente chenaḱmentem uḍuḱê tana?
The third boy (1344) was found in the winter near the farm Echtzel in Wetterau.	Third Koahon (1344) do, Rabaṅdipili Witterau ren farm Echtzel japaḱ reć nam lena.
The railway network provided critical famine relief, notably reduced the cost of moving goods, and helped nascent Indian-owned industry.	Railway network te critical famine relief em eana, goods ko ipidi reaḱ cost adit́ eana, anḍoḱ namage unduṕ akan Indian-owned industry denga eana.
It wasn't my fault.	Ańaḱ Fault kaa tana.
Everyone has the right to an effective remedy by the competent national tribunals for acts violating the fundamental rights granted him by the constitution or by law.	Constitution baredo Law teć em akan Fundamental Right ko violate ê Act ko lagit́ Competent National Tribunal taḱ aete effective Remedy namê teaḱ Right do hoo hoo taḱ re menaḱa.
India also contains four of the world's 34 biodiversity hotspots, or regions that display significant habitat loss in the presence of high endemism.	Otesaeaḱ 34 kipilijiidann hotspot (enhasaùpânaḱ ko ge sangê menaḱ loḱ significant Basapaiànat́ (habitat loss) nelnamoḱ) ko ren upunea do India re ge menaḱa.
Multicellularity.	Multicellularity.
Let's walk.	Dolabu sen baaêa.
We live on different continents.	Eṭaḱ-eṭaḱ Continent relińa.
It is sunny today.	Tisiṅać jeṭe tat́a.
Philosophers and scientists were interested in the concept of such children, and began to question if these children were part of a different species from the human family.	Philosopher,, Scientist ko, enkan Hon ko menaḱ teaḱ Concept paa te Nelònor taekena, enkan Hon ko do Hoohita aete eṭaḱ Hita ren ko chi mentekô kuli eṭeć let́ taekena.
Nice to meet you.	Am loḱ napamań raȧsa jana.
I don't have any money.	Ań taḱ jahn Puisa banoḱa.
This is achievable in some well-studied bacteria, with models of Escherichia coli metabolism now being produced and tested.	Nena do chiminaṅ Well-studied Bacteria re achieve daeoḱa, anḍoḱ Escherichia coli reaḱ Metabolism Model do nahḱ bai ooḱl tana anḍoḱ test oḱ tana.
For example, participants may take a quiz and estimate their performance afterward, which is then compared to their actual results.	For example, participant ko miat́ Quiz re duṕ eaneet́ takô performance kô estimate êa, ena ge tayom takoaḱ actual result loḱ umaaoḱa.
The soldiers surrounded the village.	Soldier ko Hatukô eset́ biur ket́a.
Sit down.	Duṕ me.
Major peninsular rivers, whose steeper gradients prevent their waters from flooding, include the Godavari, the Mahanadi, the Kaveri, and the Krishna, which also drain into the Bay of Bengal; and the Narmada and the Tapti, which drain into the Arabian Sea.	Hić láḱan Gradient te daḱ kaa bánoḱ major peninsular Gaḍa ko re Bay of Bengal re atu chabaoḱ Godavari,, Mahanadi,, Kaveri,, Krishna ko; anḍoḱ Arabian Sea re atu chabaoḱ Narmada,, Tapti ko lekaoḱa.
Don't lie!	Alape chakat́a!
You've got to take a look at this.	Nenam nelê tege hobaoḱa.
The Mauryan kings are known as much for their empire-building and determined management of public life as for Ashoka's renunciation of militarism and far-flung advocacy of the Buddhist dhamma.	Mauryan king ko Ashoka aḱ militarism banage anḍoḱ Buddha aḱ dhamma reaḱ osar-saniṅ advocacy lagit́ chimin ko nutumana, imin ge nutum empire-building anḍoḱ public Life reaḱ determined Management lagit́ ó menaḱa.
I sell tickets.	Ticket koń akarińa.
Bacteria are ubiquitous, living in every possible habitat on the planet including soil, underwater, deep in Earth's crust and even such extreme environments as acidic hot springs and radioactive waste.	Bacteria ko dokô ubiquitous gea, Hasa,, Daḱsuba,, Otechuṭiàṭal (Earth's crust) ikir ko mesakeet́ sanam tae daáe lekan habitat re menaḱkôa, Acidic Hot Spring anḍoḱ Radioactive Waste lekan Extreme Environment ko reó ge.
I am at home.	Oaḱ reńa.
I am in London.	London reńa.
The ancestors of bacteria were unicellular microorganisms that were the first forms of life to appear on Earth, about 4 billion years ago.	Bacteria koaḱ Ancestor ko do, 4 Billion sirma maaṅ Ote chetan ooḱl ean ayarùtar Jivt́form (Life form) tan Unicellular Manjivt́aḱ (Microorganism) ko.
Are you at home?	Oaḱ remea chi?
Some bacteria, called vibrio, are shaped like slightly curved rods or comma-shaped; others can be spiral-shaped, called spirilla, or tightly coiled, called spirochaetes.	Vibrio menoḱ chiminaṅ Bacteria do, jokoć lego akan Jaṭa baredo Comma lekaakô; eṭaḱ ko do Spirilla menoḱ Chunur-shape rekôa, anḍoḱ chiminaṅ Spirochaetes menoḱkô do uruć gekô binḍa akana.
Do you live here?	Nenreben taena?
How do you say XXX in Dutch?	XXX Dutch te chenaḱkô metaà?
I must study.	Ań paṛao teaḱ menaḱa.
Industries	Industry ko
Let's walk.	Dolabu sen-sen te.
Beyond the Right's populism and the dispersion of the Left which have made this situation possible, I take full responsibility for this defeat and draw the necessary conclusions by retiring from political life after the end of the presidential election.	Nen Situation possible ichi ken Right renkoaḱ Populism anḍoḱ Left renkoaḱ Dispersion kin tayomparom, ań nen Defeat reaḱ goṭa Responsibility ń goḱêa, anḍoḱ Presidential Election tunḍu ean tayom Political Life aete retire oḱ horate necessary Conclusion ko doń baiêa.
I have been acquainted with the mayor for more than twenty years.	Mayor loḱ hisi sirma aete ó láḱń upurum akana.
Look!	Haneè!
I'm not home.	Oaḱ re baṅińa.
How long did you stay?	Chimin gáṛim tae lena?
You are my friend.	Ape ge ańaḱ Juḍi ko.
"The word bacteria is the plural of the Neo-Latin bacterium, which is the Latinisation of the Ancient Greek βακτήριον (baktḗrion), the diminutive of βακτηρία (baktēría), meaning ""staff, cane"", because the first ones to be discovered were rod-shaped."	"Ayarùtar urum nam len ko do jaṭagen (rod-shaped) kô taeken te, Ancient Greek re meaning do ""Soṭa, Danḍaḱ"" hobaoḱ βακτηρία (baktēría) aḱ Dimunitive βακτήριον (baktḗrion) aḱ Laátinêa (Latinisation) tana Nama-Latin (Neo-Latin) ""Bacterium"", ena reaḱ plural ge ""Bacteria"" do."
Let's ask him.	Dolaṅ kulića.
He was given the name Saturday after the day he was found, and Mthiyane was the name of the headmistress of the Special School which took him in.	Ać nam len Musiṅ re, Saturday kô saki ket́ića, oḍoḱ Mythiyane do ać admission ken Special School ren Headmistress aḱ Nutum taekena.
I sell umbrellas.	Chatom koń aákarińa.
Have you washed the dishes?	Bela kope gasar ket́a chi?
According to the International Monetary Fund (IMF), the Indian economy in 2024 was nominally worth $3.94 trillion; it was the fifth-largest economy by market exchange rates and is, at around $15.0 trillion, the third-largest by purchasing power parity (PPP).	International Monetary Fund (IMF) lekate, 2024 re India aḱ Economy reaḱ Nominal Value $3.94 Trillion taekena; nen Economy Market Exchange Rate lekate mṍeaḱ-maraṅa, anḍoḱ $15.0 Trillion naaćpaa beṭaê Purchasing Power Parity (PPP) lekate apéaḱ-maraṅa.
Why are you angry?	Chikateben kurkur akana?
Where are you going?	Okon tema?
What are you talking about?	Chenaḱm jagarê tana?
Bacteria are everywhere.	Bacteria do sabentaḱ menaḱkôa.
Technological changes—among them, railways, canals, and the telegraph—were introduced not long after their introduction in Europe.	Europe re introduce len aete te láḱ Sipirma aurioḱ re ge—railway, ur loor (canal) anḍoḱ Telegraph emanaḱ—technological change ko introduce lena.
It can be subdivided further into broad categories of canopy density, or the proportion of the area of a forest covered by its tree canopy.	Ena ge, canopy density (Daruhunulsuṕ te umbul akan Birbêṉêl reaḱ proportion) lekaten broad category oḱge honhaṭiń daeoḱa.
I do not think that she is at home.	Oaḱ rić leka do kań adaêa.
Yanni shot and missed his heart.	Yanni aćaḱ Surt́eć toḍe pocha ket́a.
As the empire disintegrated, many among these elites were able to seek and control their own affairs.	Empire disintegrate oḱ tan loḱ, nen elite ko re ge sangi do ako akoaḱ affair ako tekô control dae taekena.
Tom said that he was afraid of snakes.	Tom men ket́a 'Biń koń borotekôa.'
Everyone went to sleep.	Saben ko gitić eana.
She considered purity to be truly important.	Purity do sari te important gea lekać nelê taekena.
I talked about the village.	Hatu reaḱń jagar ket́a.
Hessian wolf-children:â€Š15â€“7â€Š (1304, 1341 and 1344) lived with the Eurasian wolf in the forests of Hesse:.	Hesse ren Ṭẽoḱ Hon ko do (1304, 1341 oḍoḱ 1344), Hesse ren Bir ko re Eurasian Ṭẽoḱ loḱkô taekena:.
It's a war of survival.	Ena do tapae jivt́enn reaḱ Gopoć.
Sami could barely carry that suitcase.	Sami en Suitcase bat́ teć tíṅ dae taekena.
I didn't think you could eat all that.	Sabenem jom chabaêa mente kań uṛuḱ let́a.
A long time ago when Pluto was still a planet, there was a boy named Tom.	Esu sirma ayar, Pluto do Planet ge menoḱ taeken imita, Tom nutumann miat́ Hon taekena.
Tom is a very nice boy.	Tom esu bugin Sepeet́.
Quite a lot of people heard Tom yelling.	Sange noḱ ge hoo ko Tom kakala tankô ayumat́ića.
Ginger is very useful in the winter period.	Rabaṅdipili Ada esu Paeṭić emêa.
One, two, three, four, five, six, seven, eight, nine, ten.	Mit́, bar, apé, upun, mõe, turui, ai, iril, are, gel.
I demand quality work.	Quality ann Paiṭiń aásia.
The world is a village.	Otesae do miat́ Hatu.
Bacteria are also used for the bioremediation of industrial toxic wastes.	Bacteria kodo, Industrial Toxic Waste Bioremediation reókô agujoṅoḱa.
Even notebooks can be recycled.	Notebook ko ó recycle daeoḱa.
Come here.	Hućoḱ ben nente.
We are sitting around the table.	Table kuṭi mulile duṕ akana.
Bacteria play a vital role in many stages of the nutrient cycle by recycling nutrients and the fixation of nitrogen from the atmosphere.	Nutrient ko recycle ê tan loḱ,, Atmosphere ren Nitrogen fix ê tan loḱ, Bacteria kodo Nutrient Cycle ren sange Stage kore Vital Role menaḱa.
Their village is small.	Hatu takin huḍińa.
The caste system, which created a hierarchy of priests, warriors, and free peasants, but which excluded indigenous peoples by labelling their occupations impure, arose during this period.	Priest, warrior, anḍoḱ free-peasant koaḱ hierarchy bai ken, indigenous-people koaḱ banasa do impure gea mente label keet́ akô excluded ken caste system do nen period rege bai birit́ lena.
India's population grew from 361 million in 1951 to almost 1.4 billion in 2022.	India aḱ population do 1951 sirma re 361 million aete 2022 sirma re 1.4 billion jooṅ láḱ beṭa eana.
I think we'll get off at the next station.	Hućoḱ Station reliṅ aaguna toraneń menea.
He is at home.	Oaḱ re menaḱća.
Indian merchants, scholars, and sometimes armies were involved in this transmission; Southeast Asians took the initiative as well, with many sojourning in Indian seminaries and translating Buddhist and Hindu texts into their languages.	Nen transmission re Indian merchant, scholar, misâ ko do army koaḱ role taekena; ena re Indian seminary ko re basa keet́ Buddhist anḍoḱ Hindu text ko akoaḱ language te translate ê loḱ Southeast Asia ren koaḱ initiative ó taeken gea.
The leader of the Turkish government presents himself as a victim of an international conspiracy to destabilize the country.	Turkey aḱ Government ren Leader, apać do en Disum destabilize ê teaḱ miat́ Conspiracy ren Victim lekać uduṕena.
Tom is a very nice boy.	Tom esu bugin Hon.
Look at this.	Neè nelê me.
Their collective era was suffused with wide-ranging creativity, but also marked by the declining status of women, and the incorporation of untouchability into an organised system of belief.	Nekoaḱ collective-period do wide-ranging-creativity te pereć lena, mendo Êra koaḱ status-decline anḍoḱ untouchability organised-system-of-belief lekate incorporate ean teaḱ te ó urum lena.
Bacteria display a wide diversity of shapes and sizes.	Bacteria koaḱ do shape,, size re wide diversity menaḱa.
It was sunny yesterday.	Holać jeṭe let́a.
Show me how.	Uduṕańme chilikate.
The pilot hinted that it might be a UFO.	Ena do UFO toraṅ -mente Pilot kaji ingul ket́a.
Here's another Michael Jackson cover.	Neè ge miat́ nama Version eń propose ket́a.
Tom stayed awake.	Tom evn akan geć tae kena.
Show me how.	Uduṕań pe chilikate.
Nouns, adjectives, pronouns and participles are said to be declined, while verbs are said to be conjugated.	Nuútumaḱ,, Adjective,, Pronoun,, Participle ko do decline oḱa -mente menoḱa, anḍoḱ Verbs ko do, conjugate oḱa -mente menoḱa.
In 1947 the British Indian Empire was partitioned into two independent dominions, a Hindu-majority Dominion of India and a Muslim-majority Dominion of Pakistan, amid large-scale loss of life and an unprecedented migration.	1947 re large-scale gonoć anḍoḱ unprecedented migration hoban loḱ British Indian Empire do barea independent dominion oḱge partition eana, miat́ do India, Hindu-majority Dominion, anḍoḱ miat́ do Pakistan, Muslim-majority Dominion.
Let's walk.	Dolaṅ sen-sen te.
Let's play.	Dolabu inuṅa.
Why did you tell me that you didn't have a dog?	Am taḱ Seta baṅać mente chenaḱ reaḱm kajiat́ińa?
Louis Pasteur demonstrated in 1859 that the growth of microorganisms causes the fermentation process and that this growth is not due to spontaneous generation (yeasts and molds, commonly associated with fermentation, are not bacteria, but rather fungi).	Manjivt́ koaḱ Growth tege Unuput́process do hobana, anḍoḱ nen Growth do Spontaneous Generation te do ká hobana (Commonly do Unuput́ loḱ kajimesaoḱ Unuput́jaṅ anḍoḱ Guúmajaṅ do Bacteria káa, Fungi) -mente 1859 re Louis Pasteur demonstrate ket́a.
Tom lives in the village.	Tom nen Hatu reć taena.
India has been a federal republic since 1950, governed through a democratic parliamentary system.	India do 1950 sirma aete miat́ Federal Republic leka menaḱa, Democratic Parliamentary System te govern oḱ tana.
This commonly involves Bacillus thuringiensis (also called BT), a Gram-positive, soil-dwelling bacterium.	Nena re commonly do, BT ókô meta Hasa re taen Gram-positive Bacteria, Bacillus thuringiensis agujoṅoḱa.
Spanish Prime Minister Pedro Sanchez, in announcing the measures, said that starting immediately, residents would be allowed to leave their homes only to buy food or medicine, to go to work, to find medical care or to help care for the young or elderly.	Spain aḱ Prime Minister Pedro Sanchez, Measure koć kaji ḍakaraê tan re, Resident ko do, nahḱ rená aete eṭećoḱ leka, Jomaḱ baredo Reeht́ kiriń, paeṭi, Medical Care sen nam, baredo, Baleḱ baredo Haam ko nel saṕ lagit́ te sekar Oaḱ aetekô ooḱl daea -menteć kaji ket́a.
I smiled.	Landa ket́ań.
Go with me.	Dola ań loḱ.
In the biological communities surrounding hydrothermal vents and cold seeps, extremophile bacteria provide the nutrients needed to sustain life by converting dissolved compounds, such as hydrogen sulphide and methane, to energy.	Hydrothermal Vent anḍoḱ Cold Seep kuṭi koren Biological Community kore do, Extremophile Bacteria ko, Hydrogen Sulphide,, Methane lekan leaṅ akan Compound ko Energy oḱge convert keet́ Life sustain re asitiṅ Nutrient kokô provide êa.
Only around 2% of bacterial species have been fully studied.	Bacteriahita kore 2% noḱ leka sumat́ gekô study pura akana.
Robert Mayanja (1982) lost his parents in the Ugandan Civil War at the age of three, when Milton Obote's soldiers raided their village, around 50 miles (80 km) from Kampala.	Robert Mayanja (1982), 3 sirma akan re Uganda ren Civil War imita, Milton Obote aḱ Soldier ko Kampala aete 80 km saniṅ tać Hatu ko raid ket́ re, Engaàpu kineć at́ ket́kina.
She says she's homesick.	Oaḱ paa geć uṛuḱoḱ tanać men.
Tom was shot in his left leg.	Tom do lenga Kaṭa reć toḍe lena.
I have a wife.	Eraanań.
Expanding commerce during Mughal rule gave rise to new Indian commercial and political elites along the coasts of southern and eastern India.	Mughal rule imita expand oḱ tan commerce te South anḍoḱ East India coast re nama commercial anḍoḱ political elite ko nelnam eana.
We walked to the river.	Gaḍa taḱliṅ sen ket́a.
What are you cooking?	Chenaḱben isin tana?
This is a small village.	Nena do miat́ huḍiń Hatu.
We don't have that kind of money.	Imin Puisa banoḱa tabu.
India's sustained democratic freedoms are unique among the world's newer nations; however, in spite of its recent economic successes, freedom from want for its disadvantaged population remains a goal yet to be achieved.	India aḱ sustained democratic freedom do ote chetan ren nama noḱ disum ko group re unique gea; mendo, daaradaḱ economic success ko menaḱ sante, India ren disadvantage akan ko riningâ aete raa kô teaḱ goal do, sangin re menaḱ akat́ gea.
At the age of around 17, he could still not talk, and still walked and jumped like a monkey.	17 sirma hoba len re, jagar kać dae taeken gea, Gai leka geć sen,, ućenn taekena.
India has been a federal republic since 1950, governed through a democratic parliamentary system.	India do 1950 sirma aete miat́ federal-republic leka menaḱa, Democratic Parliamentary System te govern oḱ tana.
He was a stock-market tycoon until the bears got him.	Bana ko aurikô saṕić jooṅ do Stock-Market Tycoon lenać.
Bacteria inhabit the air, soil, water, acidic hot springs, radioactive waste, and the deep biosphere of Earth's crust.	Bacteria ko do, Hasa,, Daḱ,, Acidic Hot Spring,, Radioactive Waste,, Otecrust ren ikir Biosphere korekô taena.
It isn't gold.	Samaom do kaa.
That black dog sees a white cat.	En hende Seta punḍi Bilaeć nel ket́ića.
The original Indian plate makes its first appearance above the sediment in the ancient Aravalli range, which extends from the Delhi Ridge in a southwesterly direction.	India aḱ original plate do, sediment chetan re ayarutar Delhi Ridge aete south-west paa te bil akan ancient Aravalli range re nel lena.
Tom solved that problem.	Tom en Problem eć solve ket́a.
She doesn't want to be with anyone.	Jahć loḱ kaa tae sukuć tana.
How much does this cost?	Nea chimin gonoṅa?
Why are you laughing?	Chenaḱ chikape landaê tana?
Most are in the gut, though there are many on the skin.	Sange do Úr re menaḱkô reó, láḱpaa do Láć Poṭa reko taena.
I visited some Kabyle villages.	Chiminaṅ Kabyle Hatu koń sen kena.
Is mom going to the store?	Má Dokaneć sen tana chi?
Do you speak English?	English pe jagar adaana?
I am eating rice.	Manḍiń jom tana.
There is little scientific knowledge about feral children.	Birbagehon ko reaḱ Scientificsẽa do esu beteć ge menaḱa.
Don't go near this dog.	Nen Seta japaḱ alape sena.
That's the most realistic preventive measure, I think.	Ańaḱ uḍuḱ lekate, enage most realistic Preventive Measure do.
Their size was just at the limit of what his simple lenses could resolve, and, in one of the most striking hiatuses in the history of science, no one else would see them again for over a century.	Enkoaḱ Size do aćaḱ Lens ko resolve dae taeken Limit rená re taekena, anḍoḱ do, Science reaḱ History ren most striking Hiatus oḱge, mit́ Century aete láḱ leka jahć ó enko kakô nel uraa ket́koa.
Are you tired?	Laga eanaben?
I don't know when I will arrive.	Chuilań hujoḱa kań adaana.
Look here.	Nepaa nelê ben.
Do you understand me?	Ańaḱ Kajiben toḱ ket́a chi kaa?
Take medicine.	Reeht́ jomê me.
Boris arrived in the village.	Boris Hatuć tabaḱ ket́a.
Among the smallest bacteria are members of the genus Mycoplasma, which measure only 0.3 micrometres, as small as the largest viruses.	Huḍiń utar mente lekaoḱ Bacteria kore do, maraṅ utar Virus ko imin huḍiń 0.3 Micrometres ge jiliṅ Mycoplasma Genus renko.
In 2008, India's share of world trade was 1.7%; In 2021, India was the world's ninth-largest importer and the sixteenth-largest exporter.	2008 sirma, Otesai Trade re India aḱ Share do 1.7% taekena; 2021 sirma, India do Otesai ren 9aḱ maraṅ Iímportdisum anḍoḱ 16aḱ maraṅ Eéxportdisum lena.
Unlike cells of animals and other eukaryotes, bacterial cells do not contain a nucleus and rarely harbour membrane-bound organelles.	Senêjivt́,, eṭaḱ Eukaryote ko aete sapaniṅoḱge, Bacteria koaḱ Jivt́okoa redo, Okoamea (Nucleus) ká taena, anḍoḱ Membrane-bound Organelle ko do rarely ge harbour akanoḱa.
For two years he learned how to forage and travel.	Bar sirma, Forage,, Travel eć eto kena.
I am eating dinner with my husband.	Ańaḱ Koa loḱ Mandiń jom tana.
India has a space programme with several planned or completed extraterrestrial missions.	India re sapange plan akan anḍoḱ complete ean extraterrestrial-mission ko menaḱ tan Space Programme menaḱa.
I like fish.	Haku koń sukuaà.
Our source of light is the sun.	Abu Marsal ren Source do Singi.
Leon purchased a minifridge on Craigslist.	Leon Craigslist re miat́ Minifridge eć kiriń ket́a.
India's population grew from 361 million in 1951 to almost 1.4 billion in 2022.	India aḱ population do 1951 sirma re 361 million aete 2022 sirma re 1.4 billion jooṅ láḱ beṭa eana.
You are in my way.	Ańaḱ Hora remea.
Stop!	Hokaê me!
Let us plait a garland.	Miat́ Hisirbu galaṅêa.
The rat the cat the dog chased killed ate the malt.	Seta kakii ket́ić Bilae goć ket́ić Kaṭea do Omongom eć jom ket́a.
Could you send me a picture?	Miat́ Photo m kul daeańa?
I have a car.	Ań taḱ miat́ Car menaḱa.
A criticism of eugenics policies is that, regardless of whether negative or positive policies are used, they are susceptible to abuse because the genetic selection criteria are determined by whichever group has political power at the time.	Eugenics reaḱ negative,, positive bar policy re jahn miat́ salae reó ena do, genetic selection criteria enìmitaṅ political power menaḱ group ge determine ê te, abuse oḱ lagit́ susceptible ge taena mente Eugenics policies reaḱ criticism menaḱa.
The nutrient cycle includes the decomposition of dead bodies; bacteria are responsible for the putrefaction stage in this process.	Nutrient Cycle redo, Goćakanaḱ koaḱ Decomposition lekaoḱa; nen Process ren Putrefaction Stage do Bacteria ko tege hobana.
Come dance!	Dola susun pe!
I don't know what year he was born.	Okon sirmać hoba lena kań adaana.
Economic liberalisation, which began in the 1980s and the collaboration with Soviet Union for technical know-how, has created a large urban middle class, transformed India into one of the world's fastest-growing economies, and increased its geopolitical clout.	1980 ko re eoṕ len economic liberalisation te,, technical know-how lagit́ Soviet Union loḱaḱ collaboration te, miat́ large urban middle class bai hućoḱ eana,, India do Ote chetan ãachaùtar Growing Economic ko loḱ lekaoḱ ge transformer eana,, anḍoḱ India aḱ geopolitical Clout láḱ eana.
Have you taken out the garbage?	Joborape onḍoṅ ket́a chi?
Unusual for feral children, she went on to marry, have children and live a largely normal life with no persisting problems.	Birbagehon ko re nena ko do unusual gea, mendo ać tayom koć Aandi eana,, Hon ko hoba eana,, persisting Problem ko banoḱ loḱ aćaḱ Life largely normal ge taekena.
India's land is megadiverse, with four biodiversity hotspots.	Upunea Biodiversity Hotspot ko menaḱ loḱ te, India aḱ ote do megadiverse gea.
My house is far away.	Ańaḱ Oaḱ esu saniṅ rea.
Its evidence today is found in the hymns of the Rigveda.	Ena reaḱ Evidence Rigveda reaḱ Hymn kore namoḱa.
Pasteur experimented with bacteria.	Pasteur do Bacteria loḱć experiment ket́a.
It cannot plausibly be argued that behaviour of such complexity derives entirely from instinct.	Enkan complex Behaviour do goṭa Instinct sekar te ooḱl akana -mente plausibly ká argue daeoḱa.
What's he doing over there?	Enić han re chenać chika tana?
How do you say XXX in Dutch?	XXX, nena Dutch te chilikakô menea?
I have food.	Ań taḱ jomê teaḱ menaḱa.
The villagers weren't friendly.	Hatu ren ko do, japagar jupuḍi lekann ko do kakô tae kena.
Where are we right now?	Nahḱ do okontaḱ rebua?
I will be back soon.	Anjaa geń ruaaa.
The village is really close.	Hatu do naać rená rea.
Take this Kabyle dress and put it on.	Nen Kabyle Lijaḱ idi keet́, tusiṅê me.
With seven of the world's top 15 information technology outsourcing companies based in India, as of 2009, the country is viewed as the second-most favourable outsourcing destination after the United States.	Otesaiaḱ Top 15 Information Technology Outsourcing Company re aiea do India rege base akan loḱ, 2009 reaḱ Data lekate, India do United States tayom baáraḱ Most Favorable Outsourcing Destination leka nel akana.
Goodbye!	Bugi te senoḱ ben!
That's a nice village.	Esu bugi lekan Hatu ena.
Bacteria can also be used in place of pesticides in biological pest control.	Bacteria kodo Biological Pest Control re Pesticide ko satikô agujoṅ daeoḱa.
Do you like ginger?	Ada m sukutea?
In this period, people from across the political spectrum espoused eugenic ideas.	Nen period re, across political spectrum ren ko saben eugenic idea ko espouse let́ taekena.
They are sometimes the subjects of folklore and legends, often portrayed as having been raised by animals.	Enko ge misa misa kodo Folklore,, Legend ko ren Subject akanakô, often do, Birjivt́ ko hara maraṅ ken gekô portray akana.
I love you.	Abeneń sukua tana.
They said that they've been very busy.	Paeṭi rele akaratiń akan gea' -mentekô kaji ket́a.
This is not a sentence.	Nena Sentence kaa tana.
Yes.	Ea.
That disease is caused by bacteria.	En Rua do Bacteria te hoba akana.
Embracing a strong Shaivite tradition and building upon the military technology of the sultanate, the empire came to control much of peninsular India, and was to influence South Indian society for long afterwards.	Strong Shaivite tradition otoṅê loḱ, anḍoḱ sultanate aḱ military technology aete bai rakabê loḱ nen empire te goṭa noḱ peninsular India control eana, anḍoḱ tayom do sipirmaoḱ ge South India ren society influence eana.
I want vodka.	Vodka honaṅ.
It looks quite different around here than it used to.	Nepaa ko ayar aete taṅan noḱ neloḱa.
With its average annual GDP growth rate of 5.8% over the past two decades, and reaching 6.1% during 2011–2012, India is one of the world's fastest-growing economies.	Maná hisi sirma re Average Annual GDP Growth Rate 5.8% taeken loḱ,, 2011–2012 re 6.1% beṭa ken loḱ, India do Otesai Fastest Growing Economy re lekaoḱa.
We are eating.	Jom tanaliñ.
Where do you come from?	Am okon renić?
I want to eat.	Jom sukuń tana.
Are you sure?	Sari ge chi?
Do you think that you can do that for us?	Ena dom paeṭi daeabu lekam adaêa?
Man has many wishes that he does not really wish to fulfil, and it would be a misunderstanding to suppose the contrary. He wants them to remain wishes, they have value only in his imagination; their fulfilment would be a bitter disappointment to him. Such a desire is the desire for eternal life. If it were fulfilled, man would become thoroughly sick of living eternally, and yearn for death.	Hoo taḱ re sari te kać puráê sanaṅ lekan sange Sanaṅ ko menaḱa, anḍoḱ nena reaḱ Sirkat́kaji mensarinn teaḱ do Misunderstanding ge. Enako Sanaṅ lekage tae akanoḱkâ -menteć sanaṅà, enako reaḱ Value do aćaḱ Imagination re sekar menaḱa; enako reaḱ Fulfilment do aćaḱ lagit́ mér-heben Dissapointment ge. Joroṅjinivt́ reaḱ Desire do enkan miat́ Desire ge. Ena purá ean re, hoo do joroṅ-joroṅ jivt́ jivt́ teć mukuń chabaoḱa, anḍoḱ Gonoć ge nel tangià.
We help them.	Akobu dengakoa.
Where does it hurt?	Okontaḱ hasupe tana?
Ancient India	Ancient India
Mary told Tom that she thought John was unconscious.	John doć at́suti akan lekań adaêa' -mente Mary Tom taḱ reć kaji ket́a.
You look very tired.	Esu laga akan geben neloḱ tana.
In truth, a man who renders everyone their due because he fears the gallows, acts under the sway and compulsion of others, and cannot be called just. But a man who does the same from a knowledge of the true reason for laws and their necessity, acts from a firm purpose and of his own accord, and is therefore properly called just.	Sari te ma, Hakagoćpai boro te saben ko ako namê teaḱ emakô tanić do, eṭaḱ koaḱ Sway,, Compulsion te enkać paeṭiê tana, enić just do kać meta daeoḱa. Law taenn reaḱ sari-sari Reason anḍoḱ ena reaḱ Necessity chirgal keet́ enka paeṭiê nić mendo, miat́ keṭeć Purpose te anḍoḱ aćaḱ Sanaṅ te ge enkać paeṭiêa, enamente enić properly ge just menteć meta daeoḱa.
Tom has committed suicide.	Goćenn eanać Tom.
I want to learn.	Etonn sukuń tana.
Act like adults.	Maraṅ ko leka taenn me.
India is ranked 40th in the Global Innovation Index in 2023.	2023 sirma, India do Global Innovation Index re 40aḱ Rank re menaḱa.
In fact, his Bacterium was a genus that contained non-spore-forming rod-shaped bacteria, as opposed to Bacillus, a genus of spore-forming rod-shaped bacteria defined by Ehrenberg in 1835.	In fact, aćaḱ Bacterium do non-spore forming Rod-shaped Bacteria ko mesa ken Genus ge, 1835 re Ehrenberg define let́ Baccilus menoḱ spore-forming Rod-shaped Bacteria aete tannga.
They made her believe their lies.	Akoaḱ Chakat́kaji kokô sari ichi ket́ića.
It'll break.	Raput́oḱa.
The 522-million-worker Indian labour force is the world's second-largest, as of 2017.	2017 jooṅ re, 522 Million Worker ann Indian Labour Fource do Otesai reaḱ baáraḱ-maraṅaḱ tana.
Is that difficult to do?	Ena do hambal Paeṭi chi?
Sami returned to the village.	Sami Hatuć ruaa eana.
This understanding of bacterial metabolism and genetics allows the use of biotechnology to bioengineer bacteria for the production of therapeutic proteins, such as insulin, growth factors, or antibodies.	Bacteria koaḱ Metabolism onḍoḱ genetics reaḱ nelekan Urumsẽa te, Biotechnology horate Bacteria ko Insulin,, Growth Factor baredo Antibody lekan Therapeutic Protein ko baái lagit́kô bioengineer daeoḱa.
In the late Vedic period, around the 6th century BCE, the small states and chiefdoms of the Ganges Plain and the north-western regions had consolidated into 16 major oligarchies and monarchies that were known as the mahajanapadas.	600 BCE naećpaa, late-Vedic-period re, Ganga gaṛa Plain anḍoḱ north-western Region ren hupuṛiṅ state anḍoḱ chiefdom ko do, mahayenapada ko menoḱ 16 major oligarchy anḍoḱ monarchy baioḱ ge consolidate ean taekena.
India's land is megadiverse, with four biodiversity hotspots.	4 Biodiversity Hotspot ko menaḱ loḱ te, India aḱ ote do megadiverse gea.
India, officially the Republic of India (ISO: Bhārat Gaṇarājya), is a country in South Asia.	India, official nutum Republic of India (Bhārat Gaṇarājya), do South Asia reaḱ miat́ disum tana.
Where are you from?	Aben okon renkin?
Defenestrate your clock to see how time flies.	Time chilika apira mente nelê lagit́ amaḱ Clock Window hora hudumaê me.
I think about her often.	Négapa aćń uṛuḱa.
Even Tom smiled.	Tom jaket́eć landa noḱ ket́a.
Do you think Tom will reach the top of the mountain?	Tom Buruchuṭić beṭaê lekam adaić tana?
I think we should keep an eye on Tom.	Tom dobu nel akaać re bugioḱań menea.
Come eat!	Dola jomê pe!
The village was burnt down.	Hatu uruṕ chaba eana.
Did you know that Tom was going to Australia with Mary?	Tom do Mary loḱ Australia ć senoḱ taekena menteaḱ dom adaan taekena chi?
The caste system consequently began to show regional differences.	Enate, caste society re regional difference ko nelnam eana.
Because of their specificity, these pesticides are regarded as environmentally friendly, with little or no effect on humans, wildlife, pollinators, and most other beneficial insects.	Nen Pesticide ko do hoo ko,, Birjivt́,, Pollinator,, eṭaḱ Beneficial Chidu ko re Effect do jokoć ge baredo banoḱ te, akoaḱ Specificity lagit́, Environmentally Friendly kô menoḱa.
Ziri saw the destroyed village.	Ziri raput́ chaba akan Hatuć nel ket́a.
Bacteria are everywhere.	Bacteria do goṭamuli menaḱkôa.
Bounded by the Indian Ocean on the south, the Arabian Sea on the southwest, and the Bay of Bengal on the southeast, it shares land borders with Pakistan to the west; China, Nepal, and Bhutan to the north; and Bangladesh and Myanmar to the east.	South re Indian Ocean, southwest re Arabian Sea, southeast re Bay of Bengal menaḱa. West re Pakistan, North paa China, Nepal anḍoḱ Bhutan, east paa Bangladesh anḍoḱ Myanmar loḱ chirmit́ menaḱa. Indian Ocean ren Sri Lanka, Maldives naeć re menaḱa.
Do you understand me?	Ańaḱ Kajipe toḱ ket́a chi kaa?
Can I help you?	Dengameań?
Are you a student?	Iskul tanape?
While there are many cases of children being found in proximity to wild animals, there are no eyewitness accounts of animals feeding human children.	Birjivt́ ko japaḱ re Hon ko nam akan sange case ko menaḱ reó, Birjivt́ ko Hon kokô asulkô tan reaḱ Nenelmet́kanatai (eyewitness account) ko banoḱa.
Tell her that I am in a taxi.	Taxi re menaḱńa mente kajiać me.
Tom isn't a big talker.	Tom imin do kać jagar baaà.
Typically a few micrometres in length, bacteria were among the first life forms to appear on Earth, and are present in most of its habitats.	Jitiliṅ do typically chiminaṅ ge micrometer hoban Bacteria ko do, Ote chetan nel ean ayarùtar Life-form ko loḱkô lekaoḱa, anḍoḱ Ote ren sanam Habitat ko re menaḱkoa.
The village needs your help.	Hatu ren ko amaḱ Dengakô asitińoḱ tana.
Fertiliser was added to some of the beaches in Prince William Sound in an attempt to promote the growth of these naturally occurring bacteria after the 1989 Exxon Valdez oil spill.	1989 ren Exxon Valdez Sunumnur tayom, Prince William Sound ren chiminaṅ Kuṭigitil kore nelekan naturally namoḱ Bacteria ko sangeoḱka mente Fertiliser kô em let́ taekena.
Those who want to stay can stay.	Taenn sukukô tan kokô tae daea.
The oceans and seas harbour around 3 x 1026 bacteria which provide up to 50% of the oxygen humans breathe.	Ocean,, Sea kore, hoo ko saet́ê 50% Oxygen eém tan 3 x 1026 leka Bacteria ko taena.
Indian epic poetry anḍoḱ India aḱ Constitution banar re ol akan nutum Bharat (Bhārat; pronunciation: [ˈbʱaːɾət]) do, enaaḱ variation ko loḱ sapange Indian language kore ol kaji joṅoḱa.	The term Bharat (Bhārat; pronounced [ˈbʱaːɾət] ⓘ), mentioned in both Indian epic poetry and the Constitution of India, is used in its variations by many Indian languages
You are at home.	Oaḱ re menaḱmea.
I don't think that Tom is still willing to do that.	Tom nahḱ ó enać paeṭi sanaṅ tan leka do kań adaića.
No.	Kaa.
Muslim armies from Central Asia intermittently overran India's northern plains, eventually founding the Delhi Sultanate, and drawing northern India into the cosmopolitan networks of medieval Islam.	Central Asia aeten Muslim army ko intermittenly India aḱ north-plain ko attack ê taekena, eventually Delhi Sultanate ko bai bit́ ket́a, anḍoḱ enkate north-India do medieval Islam aḱ cosmopolitan Sikuar (Network) loḱkô or mesa ket́a.
I think we'll get off at the next station.	Hućoḱ Station rebu aaguna toraṅeń menea.
My name's Jack.	Ańaḱ Nutum do Jack.
Come dance!	Dola susun me!
Tom has a Ford.	Tom taḱ Ford menaḱa.
What are you looking at?	Chenaḱm nel tana?
Has Tom stayed here before?	Tom ayar ko nentaḱ reć tae akana chi?
You worked more than I did.	Ań aete láḱm paeṭi ket́a.
She smiled.	Landa ket́ać.
I'm tired.	Laga eanań.
"One of the best-documented cases has supposedly been that of sisters Amala and Kamala, described by Reverend J A L Singh in 1926 as having been ""raised by wolves"" in a forest in India."	"Kajioḱ lekate, best-documented Case kore miat́ do, India aḱ Bir re ""Ṭẽoḱ ko asul kena"" mente 1926 re Reverend J A L Singh kaji sartal ken Amala,, Kamala Unḍiboko kin."
You danced.	Susun kenape.
They live on and in plants and animals.	Enko do Sińjivt́,, Senêjivt́ ko chetan,, bitar ko taena.
I'm going to go.	Senoḱań.
We are eating.	Jom tanaliṅ.
Constituted in such fashion, India lies to the north of the equator between 6° 44′ and 35° 30′ north latitude and 68° 7′ and 97° 25′ east longitude.	Neleka bai akan India do, 6° 44′,, 35° 30′ north latitude anḍoḱ 68° 7′,, 97° 25′ east longitude tala re equator aete north re menaḱa.
Tom is looking for a vending machine.	Tom do Vending Machine eć nel baa tana.
Why are you angry?	Chikatem kurkur akana?
Are you a student?	Paṛao tanam?
Don't worry. Everything is going well.	Alam uṛuḱoḱa. Sabenaḱ bugin ge sesen tana.
Tom goes to school by bus and train.	Tom Bus te anḍoḱ Train te School eć sena.
When do you have to go to school again?	School do anḍoḱ misa chenaḱmentem senoḱ te hoban tana?
What are you eating?	Chenaḱm jom tana?
You're not the only one who doesn't believe Tom.	Tom aḱ Kaji ká sarioḱnić am sekar ge do káa.
Temple towns of various sizes began to appear everywhere as India underwent another urbanisation.	India re anḍoḱ misa hoban tan urbanisation loḱ epeṭaḱ size ren temple town ko saben muli nelnam eana.
I eat fish every week.	Jao Háṭ Hać Jiluń joóma.
Where are you?	Okon rema?
Have you finished washing the dishes?	Bela kom gasar chaba ket́a chi?
Twenty-two languages ​​are included in the eighth schedule of India.	India aḱ Irilaḱ Schedule re hisibar Janagar ko ol mesa akana.
Can I take a picture of you?	Photo pe redoń?
After Lister, however, doctors started sanitising their hands in the 1870s.	Lister tayom mendo, 1870 kore Doctor ko tako Tíkô sanitise eṭeć ket́a.
In the early 16th century, northern India, then under mainly Muslim rulers, fell again to the superior mobility and firepower of a new generation of Central Asian warriors.	Eteoṕaḱ 16th century re mainly Muslim ruler ko suba re taeken northern India, anḍoḱ misâ superior mobility anḍoḱ firepower an Central Asian warrior koaḱ nama generation taḱaete haratiṅ eana.
Are they in Paris?	Pars rekoa chi?
Everyone cries.	Saben ko raáḱa.
What is your name?	Amaḱ Nutum chenaḱa?
For about 3 billion years, most organisms were microscopic, and bacteria and archaea were the dominant forms of life.	3 Billion Serma noḱ lagit́, láḱpaa Jivt́aḱ (Organism) ko do man-man gekô taekena, Bacteria anḍoḱ Archaea ge dominant Jivt́form do.
Come here.	Hućoḱ me nente.
Layla hasn't been pregnant before.	Layla ayar ko Homoo paa re kać tae akana.
They said they thought I looked hungry.	Rengeć akan lekakô neliń taekenakô men.
Millions of people perished to the famine.	Ringa re million-million hoo ko goć eana.
The whole village was there.	Goṭa Hatu ren ko tae kena entaḱ.
Let's go!	Dolaṅ!
The rights promised to Indians were granted slowly, but technological changes were introduced, and modern ideas of education and the public life took root.	India renko taḱ promise len rights ko do mãe mãe te em eana, mendo technological-change ko introduce eana, anḍoḱ education anḍoḱ public-life reaḱ modern-idea ko bit́ keṭeć eana.
By 1200 BCE, an archaic form of Sanskrit, an Indo-European language, had diffused into India from the northwest.	1200 BCE loḱ re do, miat́ Indo-European Language Sanskrit aḱ mari Oṛoṅ (Form), northwest aete India re diffuse len taekena.
The soldier was killed in action.	En Soldier do War reć goć eana.
Antibiotics are used to treat bacterial infections and are also used in farming, making antibiotic resistance a growing problem.	Bacteria Ruachal (Bacterial Infection) buúgin re agujoṅoḱ Antibiotics kodo, Farming reó agujoṅoḱ te Antibiotic Resistance miat́ Growing Problem akana.
Child psychologist Bruno Bettelheim states that Amala and Kamala were born mentally and physically disabled.	Amala,, Kamala do hataṅhomoo disable akan gekin unduṕ lena mente Honkopsychologist Bruno Bettelheim kaji akat́a.
Adriano wandered into the village.	Adriano Hatuć honor bolo eana.
He then published his observations in a series of letters to the Royal Society of London.	Entayom aćaḱ Observation ko do Royal Society of London taḱ te kul let́ Letter Series horateć publish ket́a.
Your explanation sounds plausible, but it just doesn't hold water.	Amaḱ Explanation do ayum te Plausible gea, ena mendo patioḱ leka banoḱ renáa.
She got first prize, didn't she?	First Prize eć nam ket́a, kachia?
I'm writing about Western Sahara. Try and stop me.	Western Sahara reaḱń olê tana. Hoka daeań redom mar.
Please give that to me.	Enam emań re bugioḱa.
The soil is a rich source of bacteria and a few grams contain around a thousand million of them.	Hasa do rich Bacteria Nampai (Source) tana, chiminaṅ gram rege Thousand Million lekakô taena.
Could you send me a picture?	Miat́ Photo ben kul daeaeńa?
Tom agreed that it might happen.	Ena hobaó hoba daeoḱa mente Tom ea ket́ać.
The book is on the table.	Kitaṕ Table chetan rea.
I miss you.	Ameń uṛuḱ tana.
Tom often wears black.	Tom hende teaḱ ko geć tusiṅ baaêa.
India has substantially reduced its rate of poverty, though at the cost of increasing economic inequality.	Increasing-economic-inequality reaḱ Gonoṅ em keet́ India reaḱ poverty-rate do substantially adit́ (reduce) akana.
Do you want to rest?	Jiraonam?
Why are you laughing?	Chikatepe landaê tana?
Where is Tom?	Tom okon rića?
India has two archipelagos: the Lakshadweep, coral atolls off India's south-western coast; and the Andaman and Nicobar Islands, a volcanic chain in the Andaman Sea.	India re barea Archipelago menaḱa: India aḱ south-west Patukâm Kuṭi ren coral Atoll tan Lakshadweep; anḍoḱ Andaman Honpatukâm ren Sengelburu Chain Andaman Nicobar Island ko.
As you say.	Aben kajiê leka ge.
Come here.	Ela.
Look at this!	Neè nelê me!
Lift it up.	Chetanê pe.
I like to walk in the rain.	Gama re sen sukuńa.
These parallel chains run from the Arabian Sea coast in Gujarat in the west to the coal-rich Chota Nagpur Plateau in Jharkhand in the east.	Ena reaḱ parallel chain ko do west re Gujrat ren Arabian Sea coast aete, east ren Jharkhand aḱ coal-rich Chota Nagpur Plateau jooṅ bil akana.
Hello!	Chia!
My boyfriend works at a language school and loves it very much.	Ań jagarić Sepeet́ do miat́ Language School reć paeṭia, anḍoḱ ena esuć rãasatea.
From its pivotal role in mediating the Libyan crisis to its ongoing efforts in promoting stability in the Sahel region, Algeria has exemplified the power of dialogue in fostering sustainable peace and mitigating the impact of conflicts on civilian populations.	Libya aḱ Crisis tala duúḱ re akoaḱ Pivotal Role taeken aete Sahel Region re Stability udur tersa re akoaḱ nahḱ sesen tan Kurumuṭu jooṅ, Algeria ren ko do, sustain daeoḱ Peace usa tersa re anḍoḱ Civilian Population chetan Gopoćdaparom ko reaḱ Etelaṅ adit́ raábal re Japagar reaḱ Peećkô exemplify akat́a.
You are in my heart.	Ańaḱ Jibon re menaḱmea.
Where are you going?	Okotn tepe sen tana?
Yanni is the village chief.	Yanni do Hatu Munḍa.
During the 1930s, slow legislative reform was enacted by the British; the Indian National Congress won victories in the resulting elections.	1930 ko re, British ko mãe mãe ten Legislative Reform ko enact ket́a; ena te hoba ean Election ko re Indian National Congress dae eana.
Eschewing tribal bonds and Islamic identity, especially under Akbar, the Mughals united their far-flung realms through loyalty, expressed through a Persianised culture, to an emperor who had near-divine status.	Mughal ko, especially Akbar suba re, tribal bond anḍoḱ Islamic identity bage keet́, Persianised culture te near-divine status menaḱ tan emperor chetan re em len loyalty te, akoaḱ osar saniṅ ote chirmit́ ko unite ket́a.
It is the seventh-largest country by area; the most populous country as of June 2023; and from the time of its independence in 1947, the world's most populous democracy.	June 2023 jooṅ re nena do Area lekate 7 aḱ maraṅ disum; anḍoḱ saben ko aete láḱ population an disum tana; anḍoḱ 1947 sirma re independence aete nena do world reaḱ saben aete láḱ population an democracy tana.
Our school is in this village.	School tale nen Hatu rea.
Look at this!	Neè nelê pe!
These towels have different colors.	Nen Towel ko eṭaḱ ge net́ana.
To learn to swim I have to get in the water, otherwise I don't learn anything.	Oyar etonn lagit́ Daḱ reń aagunn te hobana, jahnaḱ kań etoêa baredo.
Most of the bacteria in and on the body are harmless or rendered so by the protective effects of the immune system, and many are beneficial, particularly the ones in the gut.	Homoo cheten,, bitar ren láḱpaa Bacteria dokô harmless gea, káakô reó ge, Immune System aḱ protective Effect tekô enka akana, sange dokô beneficial gea, particularly Láć Poṭa ren ko.
British Crown rule began in 1858.	British Crown rule 1858 re eoṕ eana.
Does Tom know French?	Tom French eć etoana chi?
By the 8th and 9th centuries, the effects were felt in Southeast Asia, as South Indian culture and political systems were exported to lands that became part of modern-day Myanmar, Thailand, Laos, Brunei, Cambodia, Vietnam, Philippines, Malaysia, and Indonesia.	8th anḍoḱ 9th century loḱ do, South India reaḱ culture anḍoḱ political sysem ko tisiṅaḱ Myanmar, Thailand, Laos, Brunei, Cambodia, Vietnam, Philippines, Malaysia anḍoḱ Indonesia re mesa ean disum ko te export ean loḱ te ena ko reaḱ epelaṅ Southeast Asia re nel eana.
Model your manners on his.	Sepentapae ko tać eto otoṅê me.
Do you want to eat?	Jomêaben?
The sultanate's raiding and weakening of the regional kingdoms of South India paved the way for the indigenous Vijayanagara Empire.	Sultanate aḱ raid ko te, anḍoḱ weak oḱ tan South India ren regional kingdom ko te indigenous Vijayanagara Empire aḱ hora bai eana.
He's not breathing!	Kać saet́ê tana!
Don't go near this dog.	Nen Seta japaḱ alam sena.
I like toasts very much.	Toast esuń sukutea.
He was in his room.	Taćaḱ Room reć taekena.
This aim of understanding the biochemistry of a cell reaches its most complex expression in the synthesis of huge amounts of enzyme kinetic and gene expression data into mathematical models of entire organisms.	Miat́ Jivt́okoa reaḱ Biochemistry urum bodeê teaḱ Aim do, sange-sange Enzyme Kinetic,, Gene Expression Data kin synthesis keet́ goṭa Jivt́aḱ reaḱ Mathematical Model ko baái re complex utar leka express oḱa.
I think Mary's skirt's too long.	Mary aḱ Skirt jiliṅ láḱ geań menea.
Nice to meet you.	Aben loḱ napameń rãasa eana.
They're awake.	Evn akanakô.
My car broke down this morning and it can't be repaired until Friday.	Ańaḱ Car tisiṅg setaḱ õa eana, anḍoḱ Friday ayarte ká bai uraa daeoḱa.
Where are you?	Okon rebena?
You've gained weight.	Hambal eanaben.
It's cold.	Rabaṅ tana.
This renewal was reflected in a flowering of sculpture and architecture, which found patrons among an urban elite.	Nen Namasanaṕ do urban Elite ko patronize let́ sculpture anḍoḱ architecture re reflect eana.
Do you live here?	Nenrepe taena?
After 6500 BCE, evidence for domestication of food crops and animals, construction of permanent structures, and storage of agricultural surplus appeared in Mehrgarh and other sites in Balochistan, Pakistan.	6500 BCE tayom, Mehrgarh anḍoḱ Pakistan aḱ Balochistan ren eṭaḱ site kore, food-corps anḍoḱ animal koaḱ domestication, permanent-structure ko reaḱ banai, anḍoḱ agricultural-surplus-storage reaḱ evidence nelnam eana.
I like you.	Abeneń sukua tana.
I want to dance.	Susun sukuń tana.
She is at home.	Oaḱ rića.
Are you a student?	Paṛao tanaben?
Though ranking 68th in global competitiveness, as of 2010, India ranks 17th in financial market sophistication, 24th in the banking sector, 44th in business sophistication, and 39th in innovation, ahead of several advanced economies.	Global Competitiveness re 68aḱ Rank re menaḱ reó ge, 2010 reaḱ Data lekate, India aḱ do, chiminaṅ Advanced Economy ko aete ó láḱ parom, Financial Market Sophistication re 17aḱ Rank, Banking Sector re 24aḱ Rank, Bussiness Sophistication re 44aḱ Rank anḍoḱ Innovation re 39aḱ Rank menaḱa.
Do you live here?	Nentaḱ repe taena?
The next decade was beset with crises: Indian participation in World War II, the Congress's final push for non-co-operation, and an upsurge of Muslim nationalism.	En tayomaḱ 10 sirma do Crisis kote toḱ lena: World War II re India ren koaḱ Menesa, Non-Cooperation lagit́ Congress aḱ chapanaṕ unuskur, anḍoḱ Muslim Nationalism reaḱ pair Ranakaṕ.
By repeatedly repulsing Mongol raiders in the 13th century, the sultanate saved India from the devastation visited on West and Central Asia, setting the scene for centuries of migration of fleeing soldiers, learned men, mystics, traders, artists, and artisans from that region into the subcontinent, thereby creating a syncretic Indo-Islamic culture in the north.	13th century re nen sultanate iate, dao ge dao Mongol raider ko darom kôl ean te, India save eana West anḍoḱ Central Asia re hoba ean devastation aete, nena ko te ge tayom en Region aete nir tan soldier, scholar, mystic, trader, artist, artisan ko chiminaṅ century subcontinent te ko migrate hućoḱ teaḱ hora bai eana, enate ge north re syncretic Indo-Islamic culture bai eana.
You danced.	Susun kenam.
I know you are struggling.	Kurumuṭunn tanabeneń adaana.
What's his name?	Aćaḱ Nutum chenaḱa?
Are they in Paris?	Paris re menaḱkoa chi?
Where do you live?	Okon repe taena?
His ideas were rejected and his book on the topic condemned by the medical community.	Medical Community taḱ aćaḱ Idea ko reject eana, anḍoḱ nen Topic re aćaḱ Sapagom ko condemn eana.
The oligarchic character of the modern English commonwealth does not rest, like many oligarchies, on the cruelty of the rich to the poor. It does not even rest on the kindness of the rich to the poor. It rests on the perennial and unfailing kindness of the poor to the rich.	Modern English Commonwealth reaḱ oligarchic Character do, sapange Oligarchy ko leka Rengeć ko chetan Naiki koaḱ Cruelty chetan ká tingu akana. Ena ma Naiki ko Rengeć ko lagit́aḱ Kindness chetan reó ká tingu akana. Ena do Rengeć ko Naiki ko lagit́aḱ perennial anḍoḱ ká-fail oḱ Kindness chetan re tingu akana.
Smile.	Landaê pe.
I am at school now and I will stay here until 8 o'clock.	Nahḱ School reńa anḍoḱ 8 saṛi jooṅ nenregeń taena.
The appointment in 1848 of Lord Dalhousie as Governor General of the East India Company set the stage for changes essential to a modern state.	1848 re Lord Dalhousie East India Company ren Governor General lekać appoint ean teaḱ te ge miat́ modern state baái ren essential change ko lagit́ stage bai eana.
Tom danced.	Tom susun kenać.
The Mughal state's economic policies, deriving most revenues from agriculture and mandating that taxes be paid in the well-regulated silver currency, caused peasants and artisans to enter larger markets.	Laaḱpaa revenue do agriculture aete hućoḱ tan, anḍoḱ tax do well-regulated silver-currency te emoḱ ka mente mandate taeken Mughal state aḱ economic policy iate peasant anḍoḱ artisan ko larger market tekô bolo eana.
I'm sorry.	Ika tańme.
Historians consider India's modern age to have begun sometime between 1848 and 1885.	Historian koaḱ menatiṅ lekate India reaḱ modern-age do 1848 anḍoḱ 1885 tala paa re eoṕ lena.
I met Tom at the airport.	Airport re Tom eń nam let́ića.
I wanna go!	Senoḱań!
Do you want to rest?	Jiraonape?
Bacteria were Leeuwenhoek's most remarkable microscopic discovery.	Leeuwenhoek aḱ Most Remarkable Discovery do Bacteria ge.
Can I help you?	Dengapeań?
Louder.	anḍoḱ keḍeć te.
The Sangam literature of the Tamil language reveals that, between 200 BCE and 200 CE, the southern peninsula was ruled by the Cheras, the Cholas, and the Pandyas, dynasties that traded extensively with the Roman Empire and with West and Southeast Asia.	200 BCE anḍoḱ 200 CE tala re, southern-peninsula do, Roman Empire anḍoḱ West anḍoḱ Southeast Asia loḱ extensive-trade taeken Chera ko, Chola ko, anḍoḱ Pandya dynasty ko rule let́ taekena mente Tamil language reaḱ Sangam literature re uduboḱ tana.
He eventually lived to the age of 80, but has also been reported as having died shortly after discovery.	Eventually 80 sirmaoḱ geć tae kena, nam ean tayom geć goć eana mente ó Report menaḱa mendo.
Come with me.	Hućoḱ pe ań loḱ.
He will get up soon.	Anjaa geć birit́ena.
How do you say XXX in Dutch?	XXX Dutch te chenaḱpe metaà?
Shut up!	Hapann pe!
The barometer is an instrument that measures atmospheric pressure, especially used to study climate and to determine altitudes.	Barometer do Atmosphere reaḱ Pressure uúmaa Sanaṕ, especially do Climate reaḱ Study re anḍoḱ Altitude urum saṕ Paeṭi re hućoḱa.
I want to go.	Senoḱ sukuń tana.
What are you laughing at?	Chenaḱm landa tana?
Do you want to help?	Dengańaben?
Let's celebrate!	Dolaṅ poroṕêa!
I am at school now and I will stay here until 8 o'clock.	Nahḱ School re menaḱńa anḍoḱ 8 saṛioḱ jooṅ nentaḱ regeń taena.
Everyone is entitled in full equality to a fair and public hearing by an independent and impartial tribunal, in the determination of his rights and obligations and of any criminal charge against him.	Saben ko ge, akoaḱ Rights, Obligation anḍoḱ ako chuúnḍul Criminal Charge ko chirgalsarioḱ tan re, independent anḍoḱ impartial Tribunal re, Full Equality loḱ fair anḍoḱ public Hearing namê teaḱkô tala akat́a.
Do you want to eat?	Jomêam?
Description.	Description.
What would you like to eat?	Chenaḱpe jomêa?
Elementary and primary school children don't yet know good from evil or reality from fiction.	Elementary anḍoḱ Primary School ren Hon ko Buginaḱ anḍoḱ Et́kanaḱ chi Reality anḍoḱ Fiction aurikô urum adaana.
It is expected to grow to US$3,264 by 2026.	Ena 2026 loḱ do US$3,264 jooṅ ayar tersana mente Expectation menaḱa.
He burned the village.	Hatuć atar ket́a.
You'd have to be insane to do that.	Bayaoḱ tan re enaṅ ena dom paeṭiêa honaṅ.
Hello, how are you?	Chie, chilika menaḱmea endo?
India's wildlife, which has traditionally been viewed with tolerance in India's culture, is supported among these forests, and elsewhere, in protected habitats.	Traditionally do Tolerance loḱ nel aguoḱ tan India aḱ Birjivt́ ko do nen Bir ko re, anḍoḱ eṭaḱ paa raka akan Habitat ko re gekô support akana.
What do you want?	Chenaḱpe nam tana?
It will rain tonight.	Tisiṅ Nidać gamaêa.
Four major climatic groupings predominate in India: tropical wet, tropical dry, subtropical humid, and montane.	India re predominantly upunea major Climatic Grouping menaḱa: Singichirmit́ Oda (Tropical Wet), Singichirmit́ Rooh (Tropical Dry), Singichirmit́suba Losom (Subtropical Humid), anḍoḱ Montane.
Come eat!	Dola jomê ben!
Let Tom go home.	Tom Oaḱ senoḱ iriê me.
We marched.	March ket́aliń.
It's raining outside right now.	Nahḱ Raca paać gamaê tana.
These efforts were effective on beaches that were not too thickly covered in oil.	Sunum te ibil rená gedo kaa bil suba len Kuṭigitil kore do nena Paeṭić em ket́ taekena.
I can't hide.	Ukunn kań daea.
The empire was once thought to have controlled most of the subcontinent except the far south, but its core regions are now thought to have been separated by large autonomous areas.	Nen empire aḱ do far South bage keet́ goṭa noḱ subcontinent re control taekena mente menoḱ taekena, mendo nahḱ menoḱ tana, core Region ko do maparaṅ autonomous Area ko te tannga lena mente.
It'll break.	Ena raput́oḱa.
Everyone has the right to an effective remedy by the competent national tribunals for acts violating the fundamental rights granted him by the constitution or by law.	Saben ko ge, akoaḱ Rights, Obligation anḍoḱ ako chuúnḍul Criminal Charge ko chirgalsarioḱ tan re, independent anḍoḱ impartial Tribunal re, Full Equality loḱ fair anḍoḱ public Hearing namê teaḱkô tala akat́a.
The Himalayas prevent cold Central Asian katabatic winds from blowing in, keeping the bulk of the Indian subcontinent warmer than most locations at similar latitudes.	Himalayburu menaḱ te, Central Asia ren Katabatic Hoyo ko koṭoṅoḱa; ena te, bulk of Indian Subcontinent do, ena loḱ mipit́noḱ Latitude ren Location ko aeteó urgumlaaḱ gea.
I can't understand anything he's saying.	Ać kajiê teaḱ jahnaḱ kań somjaooḱ tana.
Help!	Mar á!
You don't have to eat it.	Ena kam jomê reó.
This will kill the bacteria.	Nena te Bacteria ko goćoḱa.
Do you want to help?	Dengańam?
Habitat.	Habitat.
Ziri lives in a village.	Ziri Hatu reć taena.
Bastard!	Saroa lekanić!
Like all animals, humans carry vast numbers (approximately 1013 to 1014) of bacteria.	Sanam Senêjivt́ ko leka ge, hoo ko reó sange rená ge (approximately 1013 to 1014) Bacteria ko taena.
I can shoot.	Toḍe daeań.
Boris went to another village.	Boris eṭaḱ Hatuć senoḱ eana.
For example, when starved of amino acids, myxobacteria detect surrounding cells in a process known as quorum sensing, migrate towards each other, and aggregate to form fruiting bodies up to 500 micrometres long and containing approximately 100,000 bacterial cells.	Example lekate, Amino Acid kô ringa tan re, Myxobacteria do Quorum Sensing menoḱ Process te daradari ren Jivt́okoa kokô chirgalkoa, japaḱ tekô sen idina, anḍoḱ 500 micrometer jiliṅ, approximately 100,000 Bacteria Jivt́okoa lekaoḱ Fruiting Body bain gekô hunḍina.
There are islands in the sea.	Patukam re Ḍipaòte ko menaḱa.
How did you like Boston?	Boston chilikam sukuat́a?
How do you say XXX in Dutch?	XXX, nena Dutch te chilikape menea?
Where are you from?	Ape do okon renko?
I think we'll get off at the next station.	Hućoḱ Station rele aaguna toraṅeń menea.
Tom is busy now, so he can't talk with you.	Tom nahḱ Paiṭi rića, aben loḱ kać jagar daea.
"The password is ""Muiriel""."	"Password do ""Muiriel""."
I don't wear those trousers any more because they've got a big rip in them.	Maraṅ leka chachaḱ akan te, en Trouser kań tuúsiṅa.
You are my friend.	Am ge ańaḱ Juḍi.
Duck!	Ungut́enn me!
A pioneering and influential nationalist movement emerged, which was noted for nonviolent resistance and became the major factor in ending British rule.	Nonviolent-resistance lagit́ nutuman miat́ pioneering anḍoḱ influential nationalist-movement ooḱl eana, anḍoḱ enage British rule tuúnḍu teaḱ major factor bai eana.
My son was completely bald when he was born.	Unduṕ len re ańaḱ Hon do goṭa chaḍa geć taekena.
Are you hungry?	Rengećm tana?
This is a small village.	Nena do huḍiń Hatu.
Everyone fell asleep.	Saben ko duum eana.
How old are you?	Chimin sirmam hobaoḱ tana?
Yes.	Ia.
I wonder what it sounds like.	Ena chilika toraṅ ayumoḱa.
Have you taken out the garbage?	Joboraben onḍoṅ ket́a chi?
Tom closed his eyes and thought about Mary.	Tom Met́ japit́ keet́ Mary reaḱć uḍuḱ ket́a.
Die!	Goćoḱ me!
He said that he was relaxed.	Jirao akanać menteć men ket́a.
Tom said that you were sick.	Hasuoḱ tanam -mente Tom kaji let́a.
He got to his village.	Aćaḱ Hatuć beṭa ket́a.
Death is one of two things. Either it is annihilation, and the dead have no consciousness of anything; or, as we are told, it is really a change: a migration of the soul from this place to another.	Gonoć do nen barea re miat́a: Annihilation, goć akan ko jahnaḱ reaḱ Suti Chinirgal ká taena; baredo, abu ayumat́ leka, ena sarite do Change ge: nentaḱ aete eṭaḱtaḱ tenn Rva reaḱ Sepen.
Come eat!	Ela jomê me!
Just buy Tom some candy.	Tom joka Candy kiriń noḱać me.
In order to justify its war crimes, the United States bombards and annihilates entire countries in the name of liberty and democracy. Of course, companies that sell missiles to the Pentagon, as well as mercenary companies, have very little to do with liberty and democracy. In order to have more petroleum, the American economy needs to decimate millions of lives, and these wars are also beneficial to companies that sell weapons or rent out killers.	Akoaḱ War Crime justify lagit́, United States renko Liberty anḍoḱ Democracy Nutum te goṭa-goṭa Disum kokô bombard à anḍoḱkô annihilate à. Of course, Pentagon taḱ re Missile akariṅ Company renkoaḱ ó, anḍoḱ Mercenary Company renkoaḱ ó, Liberty,, Democracy loḱ do jokoć ge Relation menaḱa. Oṛoḱ láḱ Petroleum lagit́, America aḱ Economy do million-million Jiv koć goć rasumkô enaṅ, anḍoḱ nen War ko do Weapon aákariṅ baredo Goóćko rent ê Company renko lagit́ ó beneficial gea.
Saturday Mthiyane (or Mifune) (1987), a boy of around five, was found after spending about a year in the company of monkeys in KwaZulu-Natal, South Africa.	Saturday Mthiyane (Mifune menê reó) (1987), 5 sirma lekać hobaoḱ lekan Koahon do, South Africa ren KwaZulu-Natal re mit́ sirma Gai ko loḱ taekeneet́eć nam lena.
Have you finished washing the dishes?	Bela koben gasar chaba ket́a chi?
The tall woman wears a gray suit.	En salangi Êra gray teaḱ Suit eć horoḱa.
They are abundant in lakes and oceans, in arctic ice, and geothermal springs where they provide the nutrients needed to sustain life by converting dissolved compounds, such as hydrogen sulphide and methane, to energy.	Enko do, Lake re,, Ocean re,, Arctic Ice re anḍoḱ enko te Hydrogen Sulphide,, Methane lekan leaṅ akan Compound ko energy oḱ te Jinivt́ sustain oḱ Geothermal Spring ko rekô abundant gea.
Is Tom your name?	Amaḱ Nutum Tom chi?
During the same time, its nominal per capita income increased from US$64 annually to US$2,601, and its literacy rate from 16.6% to 74%.	En time-frame rege, India aḱ nominal-per-capita-income sirma re 64 US$ aete 2,601 US$ jooṅ beṭa eana, anḍoḱ literacy-rate 16.6% aete 74% jooṅ beṭa eana.
For example, they may be unable to learn to use a toilet, have trouble learning to walk upright after walking on all fours their whole lives, or display a complete lack of interest in the human activity around them.	For example, enko Aṕenpaisenjonoṅ (toilet usage) kakô eto dae emana,, goṭa Taesirma otetí akan te ombaḱ sen keet́ Mulitingusen kakô etooḱ emana,, aka daradari ren Hoosepentipí (human activity) paa te Nelònorbaánoḱkô uduṕ emanêa.
Even though Tom understood what was going on, he pretended that he didn't.	Chenaḱ hobaoḱ tana menteaḱć munḍiê taeken reó, Tom do kaa ge lekać bainn eana.
Children like jelly babies.	Hon ko Jelly Babies kô rãasatea.
Tell me again.	anḍoḱ misa kajiań pe.
"Oxford English Dictionary (third edition 2009) lekate, ""India"" nen nutum do Classical Latin re South Asia anḍoḱ enaaḱ east ren miat́ uncertain Region iíngul India aete derive akana."	"According to the Oxford English Dictionary (third edition 2009), the name ""India"" is derived from the Classical Latin India, a reference to South Asia and an uncertain region to its east"
Do you live here?	Nenrem taena?
Tom will probably be disgusted.	Tom doć hilaṅoḱa toraṅ.
Close the door.	Silpiń hanḍet́ taa ben.
Kiss me... Hey, hey! Not that type of kiss!	Chereṕiń me... Hey, hey, Enkan Chereṕ do ká!
Major agricultural products include rice, wheat, oilseed, cotton, jute, tea, sugarcane, and potatoes.	Major Síhasa Product kodo, Chauli, Gom, Sunumoḱjaṅ, Kat́som, Jute, Tea, Sugarcane, anḍoḱ Utusanga.
Bacteria usually form colonies.	Bacteria ko usually do Colony kokô baáia.
Do you want to sleep?	Gitićaben?
Why are we running?	Chenaḱ mentebu nir tana.
One morning I shot an elephant in my pyjamas.	Musiṅg Setaḱ Gitićlijaḱ akan aete Hatiń toḍe ket́ića.
Look at this.	Neè nelê ben.
The service sector makes up 55.6% of GDP, the industrial sector 26.3% and the agricultural sector 18.1%.	GDP reaḱ 55.6% do Service Sector, 26.3% do Industrial Sector, 18.1% do Síhasa (Agriculture) Sector.
As we confront the complex challenges of our time, including the resurgence of geopolitical tensions and humanitarian crises, Algeria's example reminds us of the transformative potential of dialogue and negotiation in resolving conflicts and building inclusive societies.	Geopolitical Tanáć anḍoḱ Humanitarian Crisis reaḱ Upan Unuraa ko mesa keet́aḱ, abuaḱ Singisirma ren haaḱ paṭet́ Challange ko tebu daromoḱ tan re, Algeria aḱ Example te, Conflict ko raa tuúnḍu re, anḍoḱ inclusive Sangepai baái re, Japagar anḍoḱ Negotiation reaḱ Transformative Potential bu uḍuḱ uraa ichioḱ tana.
Who are you?	Okoe ko tanape?
We are in Paris.	Paris re menaḱbua.
I sell rice.	Chauliń aákarińa.
Let's eat.	Dolaṅ jomêa.
Close the door.	Silpiń hanḍet́ thaa me.
We surrounded the village.	Hatule eset́ biur ket́a.
Don't let him drive.	Alam har irièća.
Fadil and Layla texted back and forth.	Fadil anḍoḱ Layla tepext kupul eanakin.
Russell's books should be bound in two colours, those dealing with mathematical logic in red — and all students of philosophy should read them; those dealing with ethics and politics in blue — and no one should be allowed to read them.	Russel aḱ Sapagom ko do, barea net́ te poṭomê teaḱ, Mathematical Logic ol akanaḱ ko do araḱ te, — anḍoḱ Philosophy ren saben Student ko ena kokô paṛaoê teaḱ; Ethics anḍoḱ Politics ol akanaḱ ko do líl te, — anḍoḱ ena ko do jahć ó kakô paṛao irioḱ teaḱ.
I know.	Adaanań.
Are you in London?	London re menaḱmea chi?
Don't let anybody leave this room.	Jahć ó nen Room alam bage irikôa.
Why didn't I die?	Chenaḱ mente kań goć eana?
The critical period hypothesis was first proposed by Montreal neurologist Wilder Penfield and co-author Lamar Roberts in their 1959 book Speech and Brain Mechanisms, and was popularized by Eric Lenneberg in 1967 with Biological Foundations of Language.	"Critical Period Hypothesis do ayarùtar 1959 re akinaḱ Sapagom ""Speech and Brain Mechanisms"" re Montreal ren neurologist Wilder Penfield,, co-author Lamar Roberts tekin propose let́a, oḍoḱ 1967 ren ""Biological Foundations of Language"" loḱ Eric Lenneberg popular ket́a."
It contributes 6.5% to India's GDP.	India aḱ GDP re enaaḱ Contribution do 6.5%.
There's no reason to be afraid.	Boroê teaḱ jahn Kaji ge banoḱa.
A heron, a crab, lots of fish and other creatures used to live in a pond.	Miat́ Koḱ, miat́ Kaakom, sange Há ko, anḍoḱ eṭaḱ Jivt́ann ko miat́ Banda rekô taenn taekena.
Do you speak English?	English em jagar adaana?
Tom, this is my brother, John.	Tom, neić Bokoń John.
Do you want to play?	Inuṅape?
After World War I, in which approximately one million Indians served, a new period began.	Approximately mit́ million Indian ko serve ket́ ayaraḱ World War tayom, Nama Period eoṕ eana.
What's his name?	Nutum tać chenaḱa?
Temperatures in India have risen by 0.7 °C (1.3 °F) between 1901 and 2018.	1901-2018 tala re, India aḱ Temperature do 0.7 °C láḱ eana.
Many hospitals don’t even have an ultrasound machine to check the status of a baby, said Mandsager, the medical director of obstetrics at Mercy Medical Center in Des Moines.	Sange Hospital ko re do, Láć ren Honaḱ Status neél teaḱ Ultrasound Machine ó banoḱa, -mente, Des Moines ren Mercy Medical Center ren Obstetrics Medical Director, Mandsager kaji ket́a.
Do you want to sleep?	Gitićam?
Welcome.	Joar.
The critical period hypothesis is a theory within the field of linguistics and second language acquisition that claims a person can only achieve native-like fluency in a language before a certain age.	Critical Period Hypothesis do, jaać ge reó, miat́ language eton re, native-lekan fluency do certain age auri beṭaê regeć achieve daea menten, Linguistics,, Second Language Acquisition field ren miat́ hypothesis tana.
Smile.	Landaê me.
We are eating.	Jom tanabu.
Lift it up.	Tíṅê ben.
It's none other than him.	Eṭaḱnić do ká, ać rená ge.
All were capped by the advent of independence in 1947, but tempered by the partition of India into two states: India and Pakistan.	Saben ge 1947 re Independence reaḱ Hunujuḱ te koṭoṅ ean reó, India barea State, India,, Pakistan re haṭiń ean te temper ó temper eana.
Yet, India is also shaped by seemingly unyielding poverty, both rural and urban; by religious and caste-related violence; by Maoist-inspired Naxalite insurgencies; and by separatism in Jammu and Kashmir and in Northeast India.	Enreó, India do, unyielding ge neloḱ rural,, urban ripinga te; religious,, caste-related Violence te; Maoist koaḱ te inspire akan Naxalite insurgency ko te; Jammu anḍoḱ Kashmir,, Northeast India ren separatism ko te ó shape akana.
Apea re miat́ India aḱ Sińhita (plant species) ko do Enhasaùpanaḱ (endemic) ko ge.	Fully a third of Indian plant species are endemic.
Tom lives in the village.	Tom en Hatu reć taena.
English mother-tongue speakers are embarrassed to correctly pronounce the name of the German philosopher Kant, which is a homophone for a vulgar expression referring to the female genitals.	Kui Giniuḱ iíngul Homophone tan te, Mother-tongue do English tan Speaker ko, German Philosopher Kant aḱ Nutum correctly kaji giuḱkôa.
When his successor attempted to expand eastwards, he was defeated by the Pala king of Bengal.	Aćaḱ successor east paa teć expand lekead re Bengal ren Pala king taḱaeteć haratiṅ eana.
The Dravidian languages of India were supplanted in the northern and western regions.	India aḱ northern anḍoḱ western Region ko ren Dravidian language ko do supplant eana.
Tom had no idea that Mary was planning to stay in Australia for three more days.	Mary do Australia re anḍoḱ apé singi taen teaḱć uḍuḱ baiê tana -mente Tom ká jatić aṭkar let́a.
Why are you laughing?	Chenaḱ mentem landaê tana?
Where is your father?	Amaaḱ Baṅ okon rića?
Why are you afraid?	Chenaḱ mentem boroê tana?
Where is your father?	Amaḱ Baba okon rića?
Centred around cities such as Mohenjo-daro, Harappa, Dholavira, and Kalibangan, and relying on varied forms of subsistence, the civilisation engaged robustly in crafts production and wide-ranging trade.	Tala re Mohenjo-daro, Harappa, Dholavira, anḍoḱ Kalibangan lekan city ko taeken loḱ, epeṭaḱ lekan subsistence chetan têṅgô len taeken nen civilisation crafts-production anḍoḱ wide-ranging trade re engage len taekena.
It was raining.	Gamaê taekenać.
Where do you come from?	Aben okon renkin?
I understand.	Somjaooḱ tanań.
They called the village New Amsterdam.	Nama Hatukô New Amsterdam ket́a.
How do you say XXX in English?	XXX English te chenaḱkô metaà?
It has disputes over Kashmir with its neighbours, Pakistan and China, unresolved since the mid-20th century.	Neighbour ren Pakistan anḍoḱ China loḱ 20th century aete unresolve akan Kashmir reaḱ dispute menaḱ akat́ gea.
It is a pluralistic, multilingual and multi-ethnic society.	Nena do miat́ pluralistic, multilingual anḍoḱ multi-ethnic-society tana.
Let's dance.	Dolabu susuna.
Tom said he wanted to play tennis this morning.	Tisiṅ Setaḱ, Tom do, Tennis inuṅ sanaṅiń tanać men.
He is awake.	Evn akanać.
Instead, it balanced and pacified them through new administrative practices and diverse and inclusive ruling elites, leading to more systematic, centralised, and uniform rule.	Ensati, akô do nama administrative practice ko te anḍoḱ diverse, inclusive ruling elite koaḱ iatekô balance anḍoḱ pacify ean taekena.
You are good at literature.	Literature esu bugim adaana.
I've visited the village.	Hatuń sen akana.
She lives in a village.	Ać do miat́ Hatu reć taena.
"He had lived with wolves in a dense wooded area known as ""the Hart"" for 12 years."	The Hart kô meta ibil Bir menaḱ Area re Ṭẽoḱ ko loḱ 12 sirmać taekena.
In 1830, Algeria came under French colonial rule.	1830 re, Algeria do French Colonial Rule suba lena.
I want to know.	Chirgal sukuń tana.
What does he do?	Chenaḱć paiṭia.
Tom doesn't look much older than Mary.	Tom do Mary aete láḱ maraṅ leka kać neloḱa.
Men fight with iron for gold.	Hoo ko Samaom lagit́ Meeht́ tekô gopoća.
Don't eat too many all at once.	Misa tege ena ko alam jom láḱêa.
By 400 BCE, stratification and exclusion by caste had emerged within Hinduism, and Buddhism and Jainism had arisen, proclaiming social orders unlinked to heredity.	400 BCE loḱ do Hinduism re caste lekate Stratification anḍoḱ Exclusion nelnam eana, anḍoḱ Heredity loḱ Link banoḱ Social Order proclaim ê tan Buddhism anḍoḱ Jainism eoṕ eana.
You are my friend.	Aben ge ańaḱ Juḍi kin.
After the third quarter of 2017, India surpassed the US to become the second-largest smartphone market in the world after China.	2017 apéaḱ Quarter tayom, India do US láḱparom keet́ China tayom Otesaeaḱ baáraḱ-maraṅ Smartphone Market bai eana.The Indian automotive industry, the world's second-fastest growing, increased domestic sales by 26% during 2009–2010, and exports by 36% during 2008–2009.
I'm not home on Sundays.	Sunday Musiṅ ko Oaḱ re kań taena.
The monkeys protected him in the wild.	Bir re Gai ko raka let́ića.
Feral children who lived in isolation or with animals provided examples of this dilemma.	Tapannga re baredo Birjivt́ ko loḱ taeken Birbagehon ko en Dilemma ren Example lekakô taekena.
He dressed up as a woman.	Era lekać Lijaḱ eana.
Come dance!	Dola susun ben!
Where am I from?	Okon aeteńa?
Not on my watch!	Ań menaḱ jooṅ do kaa!
Does Mary take care of you or do you take care of her?	Mary ameć nela chi am aćem nela?
My sister has ginger hair.	Unḍińkuiaḱ Bohḱbale araḱ chambara gea.
Look here.	Nepaa nelê me.
In 2006, the share of external trade in India's GDP stood at 24%, up from 6% in 1985.	2006 re, India aḱ GDP re External Trade reaḱ Share do 24% taekena, 1985 ren 6% aete láḱ.
Leave me alone!	Bage tań pe!
He is good at football.	Football esu bugić inuṅ etoêa.
Do you think that you can do that for us?	Ena dom paeṭi daeale lekam adaêa?
Towns are larger than villages.	Town ko Hatu ko aete maraṅa.
Stop!	Hokann me!
Everyone cries.	Saben ko raḱêa.
What are you eating?	Chenaḱpe jom tana?
The original study focused on logical reasoning, grammar, and social skills.	Original study re do logical reasoning,, grammar,, social skill chetan re focus taekena.
In South India, the Middle kingdoms exported Dravidian-languages scripts and religious cultures to the kingdoms of Southeast Asia.	South India re, Middle-kingdom ko Southeast-Asia ren kingdom ko paa te Dravidian language Script ko anḍoḱ religious Culture kokô export ket́a.
Mary let Tom know that she couldn't do that.	Mary do Tom 'ena kań paeṭi daea' -menteć chirgal ichi ket́ića.
The internal angles of an octagon total 1080°.	Octagon aḱ Bitar Angle ko reaḱ Senelt́ do 1080°.
Where are you going?	Okon teben sen tana?
The villagers rebuilt the road.	Hatu ren ko Horakô bai ruaa ket́a.
Let's get to work now.	Dolaṅ Paiṭi te.
Such children lack the basics of primary and secondary socialization.	Enkan Hon ko taḱ Primary,, Secondary Socialization reaḱ Reht́sẽa (basic knowledge) kaa taena.
A fly fell in the soup!	Soup re miat́ Roko iyuḱ eana!
The Dunning–Kruger effect is a cognitive bias in which people with limited competence in a particular domain overestimate their abilities.	Dunning-Kruger effect do, miat́ particular domain re limited competence menaḱ tan hoo ko, takoaḱ Ability kô overestimate ê teaḱ miat́ Cognitive Bias.
You are very brave.	Esu biyar Hoo ko tanape.
Mr. Harrison kept a parrot called Ginger.	Mr. Harrison do Ginger kô metać miat́ Miruć asul let́ića.
Botany is the scientific study of plants.	Botany do Siń ko reaḱ Science lekatenn Study.
Raised by primates/monkeys.	Primate/Gai ko haramaraṅ ken ko.
You are beautiful.	Esu bugim neloḱa.
Let's celebrate!	Dolabu poroṕêa!
They were imitated all over India and led to both the resurgence of Hinduism and the development of all modern languages of the subcontinent.	Ena ko goṭa India re imitate eana anḍoḱ enate Hinduism ó resurge eana anḍoḱ subcontinent ren saben modern language ko ó develop eana.
Gradually expanding rule of the British East India Company followed, turning India into a colonial economy, but also consolidating its sovereignty.	En tayom British East India Company renkoaḱ gradually-expanding-rule otoṅ hućoḱ eana, India dokô colonial-economy ket́a, enloḱ enaaḱ sovereignty ókô consolidate ket́a.
Why are you dancing?	Chenaḱ mentepe susun tana?
I have money.	Ań taḱ Puisa menaḱa.
However, gene sequences can be used to reconstruct the bacterial phylogeny, and these studies indicate that bacteria diverged first from the archaeal/eukaryotic lineage.	Enkareóge, Bacteria koaḱ Phylogeny reconstruct ê lagit́ Gene Sequence agujoṅ daeoḱa, nen Study kote do, Bacteria kodo ayar Archaea/Eukaryote Lineage aetekô chaṅ sangin eana mente inguloḱa.
She ripped his shirt open.	Aćaḱ Sutuieć oeć chachaḱ ket́a.
I think we'll get off at the next station.	Hućoḱ Station relaṅ aaguna toraṅeń menea.
Bacteria have DNA as genetic material.	Bacteria koaḱ Genetic Material lekate DNA menaḱa.
We are eating.	Jom tanale.
"The first boy (1304) was taken by wolves at age 3 and found when 7 or 8 by Benedictine monks, the wolves having cared for him by ""surrounding him in cold weather, and fed him the best meat from the hunt."""	"Ayaraḱ Koahon do (1304), 3 sirmać hoba akan re Ṭẽoḱ ko goḱ ket́ića, 7, 8 sirma lekać hoba len re, Ṭẽoḱ ko ""Rabaṅ re abarum tala ket́ić te, sangar agu let́ buginùtar Jilu ajom ket́ić"" tekô nelić taeken re Benedictine monk ko nam let́ića."
Do what is good to those who hate you.	Kaa bugipe tan koó bugiko pe.
The mountain ecosystem is characterized by high altitudes and extreme weather conditions.	Buru Ecosystem do usul Altitude anḍoḱ extreme Weather Condition te urumoḱa.
I wonder what it looks like.	Ena chilika toraṅ neloḱa.
British Crown rule began in 1858.	British Crown rule 1858 re eoṕ eana.
Why are you here?	Chenaḱ mente nentaḱ remea?
Are you afraid?	Boroê tanam?
According to official statistics, India's forest cover is 713,789 km2 (275,595 sq mi), which is 21.71% of the country's total land area.	Otesaeaḱ 34 kipilijiidann hotspot (enhasaùpânaḱ ko ge sange menaḱ loḱ significant Basapaiànat́ (habitat loss) nelnamoḱ) ko ren upunea do India re ge menaḱa.
Tom used to work for a big firm in Boston.	Tom do Boston re miat́ maraṅ Firm lagit́eć paeṭi kena.
Ziri returned to the village.	Ziri Hatuć ruaa eana.
I like tea.	Tea nú sukuńa.
Die!	Goćoḱ pe!
India accounts for the bulk of the Indian subcontinent, lying atop the Indian tectonic plate, a part of the Indo-Australian Plate.	Indo-Australian Plate aḱ miat́ part tan Indian-tectonic-plate chetan re menaḱ tan India do Indian subcontinent aḱ goṭa-noḱ-homoo (bulk) leka menaḱa.
I don't need anything.	Jahnaḱ ó kańaà.
We walked to the river.	Gaḍa taḱbu sen ket́a.
It predominates in the tropical moist forest of the Andaman Islands, the Western Ghats, and Northeast India.	Andaman Island,, Western Ghat,, Northeast India ko ren Singichirmit́odabir (tropical moist forest) ko re enkan Bir ge predominantly menaḱa.
Let's go!	Dola!
Are you a student?	Iskul tanam?
I sell magnets.	Magnet koń akarińa.
In South India, a progression to sedentary life is indicated by the large number of megalithic monuments dating from this period, as well as by nearby traces of agriculture, irrigation tanks, and craft traditions.	South India re, nen period paa te back-date akan maparaṅ sereṅ (megalithic) monument ko te anḍoḱ en daradari ren agriculture, irrigation tank ko, anḍoḱ craft-tradition ko reaḱ satareć ko te sedentary life paa ten Progression inguloḱ tana.
He was alone in the room.	Room re eskarć taekena.
I wonder why Tom won't sit next to me anymore.	Tom idu chenaḱ mente nahḱ ań japaḱ re kać duṕ baaà.
He is not at home.	Oaḱ re baṅać.
By this time, with its economic power severely curtailed by the British parliament and having effectively been made an arm of British administration, the East India Company began more consciously to enter non-economic arenas, including education, social reform, and culture.	Nen imita loḱ do, British parliament iate akôaḱ economic power curtail ean ko te anḍoḱ sari samanaṅ re do British administration aḱ miat́ tí bai ean ko te, East India Company ren ko adaan aete ge education, social reform, culture mesa keet́aḱ non-economic Area rekô bolo eana.
I run every day.	Dimsiń nirêa.
Don't go near this dog.	Nen Seta japaḱ alaben sena.
I just don't know what to say.	Kajiê teaḱ kań ada renáê tana.
While Caesar was alive the state was safe.	Caesar jivt́ akan re, State do horhoann ge taekena.
Can I help you?	Dengabenań?
At this altitude, the weather can change quickly and without warning.	Nen Altitude re, Weather do esu ã́cha change emanoḱa, anḍoḱ enaó Warning banoḱ tege.
"Thank you. ""You're welcome."""	"Thank you. ""É mar."""
"Those deemed ""unfit to reproduce"" often included people with mental or physical disabilities, people who scored in the low ranges on different IQ tests, criminals and ""sexual and social deviants"", and members of disfavored minority groups."	"Reproduction lagit́ unfit ge nel ean ko re, often do mental,, physical disability menaḱ ko ó, epeṭaḱ IQ test ko re low range re score ket́ ko ó, criminal ko,, ""sexual,, social deviant ko"" ó,, disfavor akan minority group ko ókô taekena."
Hindustan reaḱ meaning re variation tae aken gea, tisiṅaḱ north-India anḍoḱ Pakistan mesa keet́aḱ Region ó inguloḱ taekena, anḍoḱ goṭa noḱ India ó.	The meaning of Hindustan has varied, referring to a region encompassing present-day northern India and Pakistan or to India in its near entirety.
This village is mine!	Nan Hatu do ańaḱa!
In 1947 the British Indian Empire was partitioned into two independent dominions, a Hindu-majority Dominion of India and a Muslim-majority Dominion of Pakistan, amid large-scale loss of life and an unprecedented migration.	1947 re large Scale gonoć anḍoḱ unprecedented migration hoban loḱ British Indian Empire do barea independent dominion oḱge partition eana, miat́ do India, Hindu-majority Dominion, anḍoḱ miat́ do Pakistan, Muslim-majority Dominion.
It's sunny today.	Tisiṅgeć jeṭe tat́a.
In the 15th century, the Vijayanagara Empire created a long-lasting composite Hindu culture in south India.	15th-century re, Vijayanagara-Empire renko south-India re long-lasting-composite-Hindu-culture ko bai ket́a.
Is it true that both Tom and Mary want to do that?	Tom anḍoḱ Mary barhoo enakin paeṭi sanaṅ tan teaḱ do sari chi?
Don't worry. Everything is going well.	Alape uṛuḱoḱa. Sabenaḱ bugin ge sesen tana.
I just proposed a new version.	Nè ge miat́ nama Version eń propose ket́a.
I am in Rome now.	Nahḱ Rome reńa.
Do you understand me?	Ańaḱ Kajim toḱ ket́a chi kaa?
He was found by nobles who used the area as hunting grounds.	En area do Hunting Ground leka let́ Noble ko nam let́ića.
Tom, this is my brother, John.	Tom, neić Bauń John.
I am eating lunch with my sister.	Ajiń loḱ Tikinmanḍiń jom tana.
This is a book.	Nena miat́ Kitaṕ.
We walked to the river.	Gaḍa taḱlaṅ sen ket́a.
Are you winning?	Daeoḱ tanam chi?
Why did you lie?	Chenaḱ mente chakat́em kaji ket́a.
In those tales, the depiction of feral children included hunting for food, running on all fours instead of two, and not knowing language.	En story ko re Birbagehon koaḱ Depiction re, Jom nam te sangar tanaḱ, bar Kaṭa te ká otetí akan te nir tanaḱ, Jagar ká etoannaḱ ko taemesa kena.
She never saw her brother again.	Aćaḱ Bokote kać nel uraa ket́ića.
It's a Saxon village.	Ena Saxon Hatu.
Tom's awake.	Tom evn akanać.
Are you a student?	Iskul tanaben?
A pioneering and influential nationalist movement emerged, which was noted for nonviolent resistance and became the major factor in ending British rule.	Nonviolent Resistance lagit́ nutuman miat́ pioneering anḍoḱ influential nationalist Movement ooḱl eana, anḍoḱ enage British rule tuúnḍu teaḱ major factor bai eana.
Have you taken out the garbage?	Joboram onḍoṅ ket́a chi?
I'm not a doctor.	Doctor kaa tanań.
Come here.	Hućoḱ pe nente.
This village is boring.	Nen Hatu muúkuńa.
Jupiter is so large that all of the other planets in the solar system could fit inside of it.	Jupiter do, Solar System ren sanam Planet ko ena rekô sóṕ dae rená imin maraṅa.
In the decades following, public life gradually emerged all over India, leading eventually to the founding of the Indian National Congress in 1885.	Ena tayomaḱ decade ko re, India re public life mãe mãe te nelnam eana, anḍoḱ ena te ge 1885 re Indian National Congress bai bit́ eana.
I like learning languages.	Eṭaḱ-eṭaḱ Jagar ko etonn sukuńa.
Where are you going?	Okon tebena?
The World Bank cautions that, for India to achieve its economic potential, it must continue to focus on public sector reform, transport infrastructure, agricultural and rural development, removal of labour regulations, education, energy security, and public health and nutrition.	World Bank aete Caution em akana, India aḱ Economic Potential achieve ê lagit́, India re Public Sector Reform, Transport Infrestructure, Síhasa,, Hatusai Development, Labour Regulation Anatom, Etosẽa, Energy Security, anḍoḱ Sangekohasubanaṅ (Public Health),, Nutrition re Focus em rika idiê te hobana.
Their village is small.	Hatu takô huḍiń gea.
Marriage does not happen in the same sept.	Miat́ ge Kili re Aandi kaa hobana.
This wide variety of shapes is determined by the bacterial cell wall and cytoskeleton and is important because it can influence the ability of bacteria to acquire nutrients, attach to surfaces, swim through liquids and escape predators.	Shape ko reaḱ wide Variety do Bacteria Okoaginil (Cell Wall),, Cytoskelton te determine oḱa, anḍoḱ nena do Bacteria ko Nutrient naám re, Surface kore juaḱenn lagit́, Liíngiaḱ (Liquid) kore oyarenn, Predator ko taḱaete nirduḱnn Danae influence oḱa.
When he was around seven years old, he was brought back to civilization.	7 sirma lekać hoba len re, Civilization teć agu ruaa lena.
It is the subject of a long-standing debate in linguistics and language acquisition over the extent to which the ability to acquire language is biologically linked to developmental stages of the brain.	Linguistics,, Language Acquisition re, Language Eton Daṉaê do okon Extent jooṅ Hataṅ Haramaraṅ Stage ko loḱ Biological Link menaḱa menteaḱ long-standing debate re, nena miat́ Subject akana.
This is never going to end.	Nena kaa chabana.
Are you afraid?	Boroê tanaben?
The villages are thirsty.	Hatu re Daḱringa menaḱa.
Santiago's words still give me chills.	Santiago aḱ Kaji te nahḱ ó gisir geń adaêa.
Can you help me?	Denga daeńape chi?
Early political consolidations gave rise to the loose-knit Maurya and Gupta Empires based in the Ganges Basin.	Sidae sidaeaḱ political Consolidation te Ganga Gaḍa basin re loose-knit Maurya anḍoḱ Gupta Empire ko emerge eana.
Tell me again.	anḍoḱ misa kajiań me.
Gradually expanding rule of the British East India Company followed, turning India into a colonial economy, but also consolidating its sovereignty.	En tayom British East India Company renkoaḱ gradually-expanding-rule otoṅ hućoḱ eana, India dokô colonial-economy ket́a, enloḱ enaaḱ sovereignty ókô consolidate ket́a.
What are you cooking?	Chenaḱpe isin tana?
Am I losing?	Paḍuoḱ tanań chi?
More coffee, please.	onḍoḱ ge Coffee honaṅ.
Everybody was staring at Tom.	Saben Tom paakô heta akat́ taekena.
Let's dance.	Dolaṅ susuna.
Do what is good to those who hate you.	Kaa bugim tan koó bugiko me.
What time is the meeting?	Meeting chimita rea?
What's he doing over there?	Ać han re chenaḱć chika tana?
Come eat!	Dola jomê me!
Let's ask him.	Dolabu kulića.
He was later sent to the court of Prince Henry, and became accustomed to human society but said he preferred the wolves.	Enić tayom do Prince Henry aḱ Court teć kul eana, anḍoḱ Human Society ć nel sebe ean reó 'Ṭẽoḱ ko taḱ geń sukuat́ać' men.
Everyone fell asleep.	Saben ko duum eana.
Why are they here?	Chenaḱ mente nentaḱ rekoa?
Don't let Tom use my car.	Tom ańaḱ Car alam har irieća.
There is much debate over the timing of the critical period with respect to second-language acquisition (SLA), with estimates ranging between 2 and 13 years of age.	Estimate ko 2 aete 13 sirma jooṅ senoḱ tan loḱ, Second Language Eneto reaḱ Critical Period reaḱ Timing chetan ó esu debate menaḱa.
Scientists at the Harvard-Smithsonian Center for Astrophysics, after analyzing data from NASA's Kepler space telescope, calculated that six percent of the galaxy's 75 billion red dwarf stars have potentially habitable, Earth-sized planets. Red dwarfs — which are smaller, cooler and much dimmer than our own Sun — are the most common stars in the galaxy, so the closest Earth-like planet could be just 13 light years away, the astronomers conclude in their new study.	Harvard-Smithsonian Astrophysics Center ren Scientist ko, NASA aḱ Kepler Space Telescope aetenn Data analyse keet́, nen Galaxy ren 75 Billion Araḱ Dwarf Ipil kore 6% re, potentially Jiwt́basadaeoḱ,, Mataraṅ Ote iminoḱ Planet ko menaḱa mentekô calculate ket́a. Abuaḱ Singi aeteó huḍiṅ,, reaa,, láḱ nubaḱ gen Araḱ Dwarf ko do, Galaxy ren common utar Ipil ko, enate, japaḱ utar Ote-lekan Planet do 13 ge Marsalsirma saniṅ menaḱ toraṅ mente takoaḱ nama Study re Astronomer ko conclude ket́a.
Don't be like him.	Enić leka alam baina.
Ziri is from a village.	Ziri do Hatu aetenić.
Look at this!	Neè!
I can shoot.	Tuń daeań.
You're not as tall as Tom is.	Tom imin kam salangià.
Sometimes bears roam our village.	Ale Hatu re misa-misa Bana ko honor baaà.
We can learn a lot from children.	Hon ko taḱ aete esuaḱbu etonn daea.
You are beautiful.	Esu bugiben neloḱa.
Let's work.	Dolaṅ paitiêa.
These dual processes, driven by convection in the Earth's mantle, both created the Indian Ocean and caused the Indian continental crust eventually to under-thrust Eurasia and to uplift the Himalayas.	Ote aḱ Convection te hoban taeken en barea process te, Indian Ocean ó bai eana, anḍoḱ Indian continental crust te tayom Eurasia under-thrust ean te Himalaya buru ó udur rakaṕ eana.
They were laughing like crazy.	Bayaoḱ tan lekakô landa tan taekena.
Why is Tom here?	Tom chenaḱ mente nentaḱ rića?
Are you happy?	Rãasa rebena chi kaa?
In the 6th and 7th centuries, the first devotional hymns were created in the Tamil language.	6th anḍoḱ 7th century re, Tamil language ren ayarutar devotional-hymn ko bai eana.
You are in my heart.	Ańaḱ Jibon remea.
Sami doesn't like Layla because she is ginger.	Layla aḱ Bohḱbale araḱ chambara te Sami kać sukuteića.
I don't speak Japanese.	Japanese te kań jagar etoêa.
Their long occupation, initially in varying forms of isolation as hunter-gatherers, has made the region highly diverse, second only to Africa in human genetic diversity.	Eoṕ re hunter-gatherer ko leka varying form of isolation re taen taen te enkoaḱ sipirmaoḱgen Banasa te nen Region esu diverse eana, human-genetic-diversity lekate ma Africa sekar láḱ eana.
Sit down.	Duṕ pe.
What time is the meeting?	Dunuṕ chimite rea?
Our school is in this village.	Ale School nen Hatu rea.
The critical period hypothesis states that the first few years of life is the crucial time in which an individual can acquire a first language if presented with adequate stimuli, and that first-language acquisition relies on neuroplasticity of the brain.	Critical Period Hypothesis re, eneoṕaḱ chiminaṅ taesirma do crucial gea, lali stimuli emoḱ redo, jaać reó ge First Language kô eto daea mente ó, First Language Eneto do, Hataṅ Neuroplasticity dae suba rea mente ó menoḱa.
Come here.	Ila.
"The new home is more than one-thousand square meters. Work crews used almost ninety-one-thousand kilograms of steel to build it. About one-fifth of the steel is covered with a chemical that kills bacteria, mold and other organisms. A Massachusetts company, AgION Technologies, produces the chemical. The heating, airflow and cooling systems all are made with the treated steel. So are food preparation surfaces and other ""high-touch"" areas, along with the roof."	"Nama Oaḱ do mit́ Thousand Square Meter aete ó láḱa. Ena bai re Paiṭi Crew ko upuhisigelmit́ Thousand kilogram leka noḱ Steel kô agujoṅ ket́a. Steel mõe-re-mit́ chetan do Bacteriahita,, Guúmahita,, eṭaḱ Manjivt́ ko goóć Chemical menaḱa. AgION Technologies, miat́ Massachusetts ren Company re nen Chemical ko baioḱa. Uúrgum,, Hoyoparom,, Reéaa System ko saben nen Treated Steel te ge bai akana. Oaḱdanaṕ loḱ te, Jomaḱ Baái Surface ko,, eṭaḱ ""laaḱ jaḱoḱ"" Area ko ó enka ge."
I too like apples.	Ań ó ge Apple koń sukutea.
India do megadiverse Disum tana, nen Term do kipilijivt́ (biological diversity) sangeann (high ann) anḍoḱ Hasaùpanaḱ (Enhasaùpanaḱ) Jivt́hita ko sange menaḱ tan 17 disum ko lagit́ agujoṅoḱa.	India is a megadiverse country, a term employed for 17 countries which display high biological diversity and contain many species exclusively indigenous, or endemic, to them.
The bees followed Edmundo around and stung him.	Dumur ko Edmundo ko otoṅ baa ket́ića, anḍoḱkô tú ket́ića.
She is not home, but at school.	Oaḱ redo kaa School rića.
There is disagreement about the causes of the Dunning–Kruger effect.	Dunning–Kruger effect reaḱ cause chenaḱ tana menteaḱ re disagreement menaḱa.
I opened the can, but it was empty.	Can reaḱ Danaloṕeń hoṭaḱ ket́a, ena mendo sama ge taekena.
Tom has one younger brother.	Tom aḱ miat́ Unḍite menaḱća.
I wanna go!	Senêań!
Tom is busy now, so he can't talk with you.	Tom nahḱ Paiṭi rića, ape loḱ kać jagar daea.
Most bacteria have not been characterised and there are many species that cannot be grown in the laboratory.	Most Bacteria ko do kakô characterise chaba akana, anḍoḱ Laboratory re kako sange ichi (grow) daeoḱ lekan Hita (Species) koó menaḱa.
Where are you going?	Okon tem sen tana?
Yanni left home early in the morning.	Yanni Setaḱ re Oaḱ aete anjaa noḱć ooḱl eana.
The queen stood beside the king.	Rani do Raja japaḱ reć tingu eana.
He is at home.	Oaḱ rića.
The relative peace maintained by the empire during much of the 17th century was a factor in India's economic expansion, resulting in greater patronage of painting, literary forms, textiles, and architecture.	Goŧa noḱ 17th century re empire maintain let́ relative-peace do India aḱ economic expansion ren miat́ factor leka taekena, enate painting, literary form, textile, anḍoḱ architecture ko láḱ patronage em eana.
I like dogs.	Seta koń sukuaà.
By 1200 BCE, an archaic form of Sanskrit, an Indo-European language, had diffused into India from the northwest.	1200 BCE loḱ re do, miat́ Indo-European Language Sanskrit aḱ mari Oṛoṅ (Form), northwest aete India re diffuse len taekena.
We saw the whole thing.	Goṭale nel ket́a.
Most historians also consider this period to have encompassed several waves of Indo-Aryan migration into the subcontinent from the north-west.	Laaḱpaa historian koaḱ manatiṅ lekate nen period rege Indo-Aryan koaḱ north-west paa aete subcontinent bitâr ten chiminaṅ wave ren migration hoba lena.
Who's taller, you or me?	Okoć láḱ salangia, am chi ań?
India's wildlife, which has traditionally been viewed with tolerance in India's culture, is supported among these forests, and elsewhere, in protected habitats.	Traditionally do Tolerance loḱ nel aguoḱ tan India aḱ Birjivt́ ko do nen Bir ko re, anḍoḱ eṭaḱ paa raka akan Habitat ko re gekô support akana.
That old house is thought to be haunted.	En papari Oaḱ do 'Bonga ko menaḱa' kô menêa.
Are you at home?	Oaḱ re menaḱmea chi?
Among the socio-economic challenges India faces are gender inequality, child malnutrition, and rising levels of air pollution.	India sanamaṅ re menaḱ tan socio-economic-challange ko do, gender-inequality, child-malnurition anḍoḱ level-rise oḱ tan air-pollution.
Under the Guptas, a renewed Hinduism based on devotion, rather than the management of ritual, began to assert itself.	Critical Period Hypothesis re, eneoṕaḱ chiminaṅ taesirma do crucial gea, lali stimuli emoḱ redo, jaać reó ge First Language kô eto daea mente ó, First Language Eneto do, Hataṅ Neuroplasticity dae suba rea mente ó menoḱa.
They constitute a large domain of prokaryotic microorganisms.	Enko Prokaryotic Manjinivt́ ko (Microorganisms) Domain ren maraṅ Hitat́ ge.
Act like adults.	Maraṅ ko leka taenn ben.
Muslim armies from Central Asia intermittently overran India's northern plains, eventually founding the Delhi Sultanate, and drawing northern India into the cosmopolitan networks of medieval Islam.	Central Asia aeten Muslim army ko intermittenly India aḱ north-plain ko attack ê taekena, eventually Delhi Sultanate ko bai bit́ ket́a, anḍoḱ enkate north-India do medieval Islam aḱ cosmopolitan Sikuar (Network) loḱkô or mesa ket́a.
Tell me.	Kajiań pe.
Some 431 million Indians have left poverty since 1985; India's middle classes are projected to number around 580 million by 2030.	1985 aete, 431 Million leka India renko Ripinga aetekô atom akana; 2030 jooṅ do, India aḱ Middle Class koaḱ leneka 580 Million leka hobana mente project akana.
Where do you live?	Okon reben taena?
All the villagers know him.	Hatu ren saben ko chirgal tat́ića.
The researchers were able to estimate that the polar bears' ancestors branched off from the brown bear population when they headed north and adapted to the Arctic habitat, becoming a separate species about 150,000 years ago.	Punḍi Bana aḱ Ancestor ko North paa senoḱ ean aete Arctic Habitat rekô adapt ean re, 150,000 leka sirma maaṅ tannga Species kô baioḱ leka, Brown Bana koaḱ Population aetekô chaṅ tannga eana, -mentekô estimate daeat́a Researcher ko.
Why is Tom wet?	Tom chenaḱ menteć lum akana?
In recent years, the term has seen a revival in bioethical discussions on the usage of new technologies such as CRISPR and genetic screening, with heated debate around whether these technologies should be considered eugenics or not.	Daaradaḱ sirma ko re do, nen term do CRISPR anḍoḱ genetic screening lekan nama technology reaḱ usage reaḱ bioethical discussion ko re agu ruaa akana, nekan technology ko do Eugenics mene re bugia chi kaa mente heated debate hoban tan gea.
The various modes of worship which prevailed in the Roman world were all considered by the people as equally true; by the philosopher as equally false; and by the magistrate as equally useful. And thus toleration produced not only mutual indulgence, but even religious concord.	Roman World re taeken Bongaburu reaḱ sange Mode ko sanam, hoo ko do equally sarià -mente; Philosopher ko do equally False à -mente; anḍoḱ Magistrate do equally useful à -menteć nelê taekena. Anḍoḱ enkate, Toleration te, mutual Indulgence sekar ge do ká, religious Concord ó produce eana.
Lift it up.	Tíṅê me.
India's foreign exchange remittances of US$100 billion in 2022, highest in the world, were contributed to its economy by 32 million Indians working in foreign countries.	2022 re, Otesai re ge highest, US$100 Billion hoban, India aḱ Foreign Exchange Remittance do, Foreign Disum kore paiṭi tan 32 Million India renko India aḱ Economy rekô em mesa ket́a.
Tom is standing in front of the school.	Tom School samanaṅ reć tingu akana.
